かすがのやちよ	春日野八千代	人名
まつもとゆり	松本悠里	人名
きょうみさ	京三紗	人名
いつきちひろ	一樹千尋	人名
こうあけみ	光あけみ	人名


あいぞのゆか	藍園ゆか	人名
あきらみやび	晃みやび	人名
あこちなみ	亜湖千波	人名
あさみつる	麻みつる	人名
あしさおり	芦沙織	人名
いずようこ	伊豆踊子	人名
うしおはるか	潮はるか	人名
かつみひろし	克美仁	人名
かもづるみき	賀茂鶴みき	人名
かんなあい	神奈吾衣	人名
きたこうじみほ	北小路みほ	人名
きたはらちこと	北原千琴	人名
きぬがさあきら	衣笠彰	人名
きょうみさこ	京三紗子	人名
きりゅうのぼる	桐生のぼる	人名
くれたけひかる	呉竹晃	人名
くれないひとみ	紅ひとみ	人名
けいかがり	圭加々利	人名
こうちひろき	高地ひろき	人名
こはやかわゆき	小早川有希	人名
さかきなお	榊なお	人名
さらけい	沙羅けい	人名
さんじょうありさ	三条有左	人名
しんさやき	真さや希	人名
たかおかけいこ	高丘けい子	人名
たかしょうめぐみ	鷹匠恵	人名
たかつくみ	貴津句美	人名
たまよせひかる	玉寄ひかる	人名
たまるいこ	珠るい子	人名
ちさとひろみ	千里ひろみ	人名
ともちはる	友ちはる	人名
とりゅうみち	登流路	人名
なかいおり	央いおり	人名
なつきてる	夏季暉	人名
なとりれい	汝鳥玲	人名
にしきのはなよ	錦乃花世	人名
はづきしげる	葉月しげる	人名
はにりお	埴りお	人名
はやぶさあみり	隼あみり	人名
ほうじょうひろき	鳳城ひろき	人名
ほなみまこと	帆波真琴	人名
まぎりあや	真桐彩	人名
まなひろか	真南ひろか	人名
まりれいか	毬れいか	人名
みしえる	美詩える	人名
みたまちよ	美珠千代	人名
みほまりか	美甫まりか	人名
もんあみ	紋あみ	人名
ゆうしらべ	優しらべ	人名
ゆづきかおる	佑月薫	人名
ゆめまどか	夢まどか	人名
よしのまな	美野真奈	人名
るいあづち	塁あづち	人名
れみりょう	礼美良	人名
れんちお	漣千央	人名


あかつきるみ	暁留美	人名
あかねまゆみ	茜真弓	人名
あらたみき	新みき	人名
あらんみか	亜蘭美香	人名
うみしらほ	海しらほ	人名
うめざとちえり	梅里ちえり	人名
えまちあき	江真千晶	人名
かぜかおる	風かおる	人名
かつらみき	桂美紀	人名
くになつき	邦なつき	人名
くみまり	久美まり	人名
ここまりも	湖々まりも	人名
ごしょまゆか	御所まゆか	人名
ごじょうあいせん	五條愛川	人名
ことぶきひづる	寿ひづる	人名
さおりみつよ	早織光世	人名
すみかわあけみ	純川暁美	人名
そのみはる	園みはる	人名
たかまりお	孝まりお	人名
たかしおともえ	高汐巴	人名
たかほりな	高帆里奈	人名
ちしろけい	千城恵	人名
ちなゆみの	千奈ゆみの	人名
ちひろさかえ	千尋栄	人名
ちぶねゆか	千船友歌	人名
なぎりよう	波切洋	人名
なるみゆき	成美有紀	人名
ののひかり	野々ひかり	人名
はとぶえまき	鳩笛真季	人名
はなぞのまり	花園まり	人名
はなみかおり	花美香	人名
ひかりかおこ	光香王子	人名
びゃくどうれいな	白道れい奈	人名
ふじなみゆう	藤波ゆう	人名
まきなえりか	牧奈えりか	人名
ましおちなみ	真汐ちなみ	人名
ましばしん	真柴真	人名
まつかぜさとみ	松風都巳	人名
まりひかる	麻里光	人名
みかどゆき	美門有輝	人名
みちのぼる	路のぼる	人名
みねさおり	峰さを理	人名
みのりあき	實亜紀	人名
やしろはるな	八代東奈	人名
ゆうづるまい	夕鶴まい	人名
ゆうびあい	優美あい	人名
ゆきれいな	有季れいな	人名
ゆたかあゆむ	裕あゆむ	人名



あやこまき	綾こまき	人名
あんうらら	杏うらら	人名
いくかつみ	育かつみ	人名
いなばかよ	稲葉かよ	人名
うらまつほ	浦まつほ	人名
えいなかおる	英奈かほる	人名
おうわたる	欧わたる	人名
おおづきせりか	凰月せりか	人名
かざまいりや	風間イリヤ	人名
かじりゅうこ	楫竜子	人名
こいのぼる	鯉のぼる	人名
こじょうちあき	湖条千秋	人名
ことさおり	琴さおり	人名
さちかおる	沙智薫	人名
さわなもえ	沢奈もえ	人名
しきいずみ	紫城いずみ	人名
しきのはなえ	四季乃花恵	人名
しのじりさ	紫乃路りさ	人名
しまはるき	紫摩はるき	人名
しゃみよ	謝美世	人名
しわきょうこ	志和杏子	人名
しんもえる	真もえる	人名
じんなつみ	陣夏実	人名
すがたはるか	姿晴香	人名
せりまちか	芹まちか	人名
せんなつこ	泉奈都子	人名
だいちまお	大地真央	人名
たいらみち	平みち	人名
たきあずさ	多岐あずさ	人名
たまきあやめ	珠希あやめ	人名
だんなつき	団なつき	人名
ちはらゆうり	千原悠利	人名
なみじようこ	南美路遥子	人名
はなおまき	花尾まき	人名
ひだみどり	飛騨翠	人名
ひろきじゅん	広樹淳	人名
ほくとひかる	北斗ひかる	人名
まきさやか	槇さやか	人名
みかみみゆり	三神美百合	人名
みさのえる	未沙のえる	人名
みずさわゆき	水沢柚紀	人名
みちあんり	未知あんり	人名
みなゆきほ	水奈ゆきほ	人名
みなみまりよ	南万里代	人名
みわちぐさ	美和ちぐさ	人名
もえぎなつ	萠季夏	人名
やましろはるか	山城はるか	人名
ゆみましろ	由美ましろ	人名
らんさがの	嵐さがの	人名



あおきりょう	青樹りょう	人名
あきかのう	亜希かのう	人名
あけちきほ	明知希帆	人名
あゆはらさなえ	鮎原さなえ	人名
いそのちひろ	磯野千尋	人名
おおうらみずき	大浦みずき	人名
おおたてはと	大立鳩	人名
きくかおる	貴久香	人名
こうじょうひろみ	光城ひろみ	人名
こしふじこ	越富士子	人名
しらゆきあい	白雪愛	人名
せんじゅけい	千寿慧	人名
そらたかこ	空タカ子	人名
たえくるみ	妙くるみ	人名
たけはらさゆり	竹原小百合	人名
たちばなまりこ	橘万里子	人名
ちあきまなか	千晶まなか	人名
つきおかちかげ	月丘千景	人名
つるぎみゆき	剣幸	人名
なつせあまね	夏瀬あまね	人名
ななあさみ	奈々あさみ	人名
なるかみじゅん	鳴上順	人名
のぞみゆうこ	希夕子	人名
のばらあけみ	野ばら朱実	人名
はやみりつ	早美律	人名
はるかくらら	遥くらら	人名
ひなみれいか	日南れい香	人名
ひめはくちょう	姫白鳥	人名
まちゆう	街ゆう	人名
まつかみちる	松香みちる	人名
まのゆりあ	真乃ゆりあ	人名
みおはじめ	未央一	人名
みかちえり	美花ちえり	人名
みやつかさ	宮つかさ	人名
めぐみはなえ	恵花恵	人名
やさとごう	八郷ごう	人名
やまざとしおり	山里栞	人名
らんこのみ	蘭このみ	人名
わかみやあいの	若宮あいの	人名
わこうあすか	若生あすか	人名



あいだまち	愛田まち	人名
あごうさち	あごう沙知	人名
あさひかり	麻光	人名
あさかじゅん	朝香じゅん	人名
あさかぜめぐみ	朝風めぐみ	人名
あらたちひろ	新千宏	人名
あんじょうひじり	安城聖	人名
いすずさより	五十鈴さより	人名
いちはらけい	一原けい	人名
えびらかおる	箙かおる	人名
えりみゆき	江里美幸	人名
おうぎちか	扇千花	人名
おおかわれお	大川令於	人名
おおしろつばさ	大城つばさ	人名
かげちさと	影ちさと	人名
かざほりさ	風帆里紗	人名
きりさとみ	桐さと実	人名
こじょうれいか	湖条れいか	人名
さいじょうあんな	西城杏奈	人名
さおとめまりあ	早乙女マリア	人名
すじゃくかおる	朱雀薫	人名
すずみね	鈴美音	人名
せおはやみ	瀬尾はやみ	人名
せんみどり	千みどり	人名
たまきじゅん	環潤	人名
ちどりさくら	千鳥さくら	人名
ときのぼる	朱鷺のぼる	人名
なぎまさみ	奈樹まさみ	人名
なちまさる	奈知優	人名
なつかわゆかり	夏川ゆかり	人名
なつきじゅん	夏城淳	人名
はなじょうまりえ	花篠まり恵	人名
はなみやらら	花宮らら	人名
ひのとりみな	火の鳥美奈	人名
ほしづきみさ	星月美砂	人名
ほだかまり	穂高真理	人名
まいずみさり	麻泉沙里	人名
まやみつほ	摩耶みつほ	人名
まゆなつみ	麻由なつみ	人名
みずきせい	瑞城聖	人名
みふねさち	美舟幸	人名
みよかおり	美代かほり	人名
ゆうひかり	優ひかり	人名
りかまなみ	梨花まなみ	人名
れいさぎり	礼さぎり	人名
わかばひろみ	若葉ひろみ	人名



あけほめみ	朱穂芽美	人名
あすかゆう	飛鳥裕	人名
あみじゅん	亜実じゅん	人名
あやはろみ	綾羽絽美	人名
ありさゆみか	有紗ゆ美か	人名
いぶきあい	伊吹あい	人名
えばらみこと	江原美琴	人名
えみちなつ	江美千夏	人名
おりづるらん	折鶴蘭	人名
かずさまき	和佐まき	人名
かちょういつき	花鳥いつき	人名
かもせんじょう	加茂千条	人名
きさらぎみれい	如月巳麗	人名
きりしません	霧島仟	人名
こうなおみ	幸直美	人名
ことづきちこ	琴月千湖	人名
さとみひろ	里美宏	人名
しおみつる	汐みつる	人名
せがわかえ	瀬川佳英	人名
たかせみあ	高瀬美亜	人名
たかみねはるか	高峰はるか	人名
たつきゆう	立木夕雨	人名
ちなみしょう	千波翔	人名
ちはやひろみ	千速紘実	人名
ちほさやか	千帆さやか	人名
つくしきょう	九十九恭	人名
つづれさみ	つづれ沙実	人名
ともちふゆ	知直冬	人名
なつますみ	夏ますみ	人名
なつみよう	夏美よう	人名
ななおとも	奈々央とも	人名
はなさきかおり	花咲かおり	人名
はるのみりか	春乃美里花	人名
ひゅうがかおる	日向薫	人名
ふじやよい	冨士やよひ	人名
ふぶきひとみ	吹雪仁美	人名
ほうじょうさゆり	宝城さゆり	人名
まさきこう	正規煌	人名
みかぜりざ	美風りざ	人名
みさきあゆみ	美咲あゆみ	人名
みずしまそのお	瑞志麻そのを	人名
みそのじゅり	美薗珠里	人名
みやびまり	雅まり	人名
みれいつくし	美嶺つくし	人名
ゆきしろまりか	雪城まりか	人名
りゅうらいか	竜らいか	人名
わかくさかおる	若草かおる	人名
わかなくみ	若菜くみ	人名



あいなまゆき	愛奈まゆき	人名
あいはらさゆみ	愛原さゆ美	人名
あおいみや	葵美哉	人名
あかつきみさと	暁美里	人名
あさかわみさ	麻川美紗	人名
あさひなひかる	朝日奈光	人名
あしぶえるか	葦笛るか	人名
あずさのぼる	梓のぼる	人名
あそういずみ	麻生いず美	人名
あづみれいか	あづみれいか	人名
あやたつみ	彩辰美	人名
ありすみき	ありす未来	人名
いちじょうけん	一城けん	人名
いづきゆか	いづき結花	人名
おうなつき	旺なつき	人名
かのうるい	叶るい	人名
ことちはる	古都ちはる	人名
さえぐさみき	三枝みき	人名
さきえりさ	咲衣里紗	人名
さほまさよ	佐保雅世	人名
さやはつか	さや初夏	人名
しじょうななほ	詩条なな帆	人名
しほうゆき	紫峰ゆき	人名
たかしろまや	貴城麻也	人名
たかねしのぶ	高嶺忍	人名
つづみちな	鼓千奈	人名
ときわさちこ	常盤幸子	人名
なおきりえ	直城理恵	人名
なみゆりか	奈美ゆりか	人名
はつしろいずる	初城いづる	人名
はやぶされん	隼れん	人名
ひとみまり	瞳真理	人名
ひらぎのゆかり	柊乃ゆかり	人名
ふじはなゆきえ	藤花雪絵	人名
ふゆきこずえ	冬城梢	人名
まいくにか	麻衣くにか	人名
まいかぜなみ	舞風奈三	人名
まきりさ	真樹りさ	人名
まことあい	真琴愛	人名
まふえひびき	真笛ひびき	人名
みさわゆり	美佐和ゆり	人名
みねしろとわ	峰城とわ	人名
みゆきはなよ	美雪花代	人名
ゆうづきまほ	優月真帆	人名
よううらら	陽うらら	人名
りょうみお	涼美緒	人名



あいかわまき	愛川麻貴	人名
あおやぎゆき	青柳有紀	人名
あかしのぼる	明石昇	人名
あきしのみほ	秋篠美帆	人名
あすなかりん	あすな花梨	人名
あんどうなち	杏東なち	人名
うららたまき	麗たまき	人名
かおるれな	薫怜奈	人名
かさいりか	加彩りか	人名
かしわぎけい	柏木けい	人名
かつらぎゆい	葛城ゆい	人名
かみしろしょうこ	上代粧子	人名
かもがわしぶき	加茂川志ぶき	人名
きたいずみ	北いずみ	人名
きぬなみき	絹なみ紀	人名
くさぶえまさこ	草笛雅子	人名
けいなつこ	渓夏子	人名
げんさやか	弦さやか	人名
ごうまゆか	郷真由加	人名
こちょうまいか	胡蝶舞花	人名
このみしま	このみ芝麻	人名
しおんゆう	紫苑ゆう	人名
せりなかぐさ	芹名香草	人名
たかはらるみか	高原るみ花	人名
たくみこう	匠鴻	人名
たけしろことえ	竹城琴絵	人名
たまみゆき	珠みゆき	人名
ちなつさゆり	千夏さゆり	人名
つばさひかる	翼ひかる	人名
つばさゆうき	翼悠貴	人名
なぎさりら	渚りら	人名
にしきもゆ	にしき望結	人名
にしなゆり	仁科有理	人名
はなかよの	花佳世乃	人名
はなだあい	花田あい	人名
ひいらぎかずき	柊和希	人名
ひびきみと	ひびき美都	人名
ふみさかえ	富美さかえ	人名
ほしむられお	星邑礼緒	人名
まいなゆみ	舞奈ゆみ	人名
みおりゆみの	御織ゆみ乃	人名
やよじるか	八世路るか	人名
ゆうなぎしほ	夕なぎ志帆	人名
ゆめぞのあやめ	夢苑あやめ	人名
れいかりゅう	麗香龍	人名
わかさつき	和花さつ希	人名



あおもゆる	青もゆる	人名
あきつゆたか	明都ゆたか	人名
あけどりてるひ	朱鳥てるひ	人名
あさおかまい	麻岡真衣	人名
あしかわまき	葦川牧	人名
あやかげじゅん	彩景じゅん	人名
あやのにしき	綾乃にしき	人名
いけなみゆかり	池波ゆかり	人名
いちもんじしん	一文字新	人名
かがりあきら	篝輝	人名
きしろなつき	希城なつ紀	人名
きよまさみ	清まさみ	人名
こだいみずき	古代みず希	人名
さえづきみわ	冴月美和	人名
さつきりせ	五月梨世	人名
さよあかり	沙世あかり	人名
じゅんなめぐ	純奈めぐ	人名
しらかわあき	白川亜樹	人名
しらべゆう	調ゆう	人名
すずしろまりや	鈴代まりや	人名
そらちぐさ	空千草	人名
たちはらかえ	立原かえ	人名
たまうらあこ	珠浦阿湖	人名
たまなめい	たまなめい	人名
ちさまゆか	千沙まゆ香	人名
とわだますみ	十和田真澄	人名
なつのようこ	夏野陽子	人名
のぞえさゆき	野添さゆ紀	人名
ののみやあき	野々宮あき	人名
はなおかれみ	華丘玲巳	人名
はやせわたる	早瀬わたる	人名
はるかぜひとみ	春風ひとみ	人名
はるのあいり	春野亜衣梨	人名
はるのありさ	春野亜里紗	人名
ひしょうひかる	飛翔ひかる	人名
ひのきせいら	檜せいら	人名
まちだなな	街田奈々	人名
まりむらなお	鞠村奈緒	人名
みつきゆう	光木裕	人名
みなかぜまい	南風まい	人名
もりけあき	杜けあき	人名
ゆうきまゆ	結城繭	人名
ゆきあずさ	由樹あずさ	人名
ゆりかおる	由梨かおる	人名
わたりはや	渡はや	人名



あさぶきなお	朝吹奈央	人名
あやかゆい	彩花ゆい	人名
ありみねりき	有峰里妃	人名
あんじゅみら	安寿ミラ	人名
いおりなつや	伊織なつ耶	人名
えりなじゅん	絵里奈じゅん	人名
おおさとみか	大里三佳	人名
おおぞらのぞみ	大空希望	人名
おおつあすか	大都あすか	人名
かあいもと	花愛望都	人名
かいさはる	櫂早春	人名
かすがまち	春日万知	人名
かやまちい	華山知位	人名
くにしろまや	邦城麻矢	人名
くるみじゅん	久留実純	人名
こうきらら	煌きらら	人名
こえいかなこ	湖映佳奈子	人名
こずえまなみ	梢真奈美	人名
こだまあい	こだま愛	人名
さちしのぶ	左知しのぶ	人名
さやかまちこ	沙耶花まち子	人名
さわちはる	沢千春	人名
さんじょうれい	三城礼	人名
しまゆうか	洲悠花	人名
せんじゅひかる	千珠晄	人名
だいごゆき	醍醐柚希	人名
たにみつる	谷みつる	人名
ちぐさまみ	千種まみ	人名
ちさきあいか	千咲あい花	人名
なしろえりか	奈代えりか	人名
なづきかなで	名月かなで	人名
なつおちか	夏生ちか	人名
ななせゆみ	七瀬ゆみ	人名
はなぶさまき	英マキ	人名
はなやけいこ	花彌恵子	人名
ひなつむぎ	日夏麦	人名
ふくじゅゆき	福寿ゆき	人名
ふゆづきしおか	冬月汐佳	人名
ほうじょうつぐみ	北條つぐみ	人名
まつみやふゆ	松宮芙夕	人名
まりやともこ	毬谷友子	人名
みかげしおり	美影しおり	人名
みさきこう	岬甲	人名
みねおかなち	峰丘奈知	人名
みやこのさくら	都乃さくら	人名
ももりえこ	桃梨江子	人名
やまとなつき	大和なつ希	人名
ゆうきこころ	友樹こころ	人名
りぐありさ	有具アリサ	人名
わかふじりら	若藤りら	人名



あいゆりや	愛ゆりや	人名
あいこうみつる	愛甲充	人名
あきひさと	安輝ひさと	人名
あぎかつら	阿樹かつら	人名
あさぐもこがね	朝雲こがね	人名
いずみつかさ	泉つかさ	人名
うたしきあやか	歌敷綾花	人名
えのきりか	榎利佳	人名
おおさきみか	大咲実果	人名
かざはやみほ	風早三穂	人名
かじいっせい	舵一星	人名
かみさつき	賀美さつき	人名
きたはらようこ	北原遙子	人名
きよかしのぶ	潔香しのぶ	人名
くろきひとみ	黒木瞳	人名
さおとめさち	小乙女幸	人名
さぎりじゅん	沙霧じゅん	人名
さちかぜいれね	幸風イレネ	人名
すずかぜまよ	涼風真世	人名
なつきとも	夏樹智	人名
なつくさかおり	夏草かをり	人名
なみきかおり	並樹かおり	人名
なんごうきえ	南郷希恵	人名
はぎなおみ	萩奈緒美	人名
はなあかり	花朱里	人名
ふづきれい	文月玲	人名
まいきあや	舞希彩	人名
ますみゆたか	増美ゆた賀	人名
まちまりい	街麻利衣	人名
まやみき	真矢みき	人名
まりいつか	麻梨いつか	人名
まりもえり	毬藻えり	人名
みずはらたまき	水原環	人名
みつやなお	三ツ矢直生	人名
みどりなかようこ	緑中陽子	人名
みやまりな	宮麻里奈	人名
ゆうしおまなか	佑汐まな花	人名
ようあきら	燁明	人名
りかますみ	梨花ますみ	人名



あかねよしみ	茜佳実	人名
あさなぎりん	朝凪鈴	人名
あやせるり	綾瀬るり	人名
いちろまき	一路万輝	人名
えまなおき	英真なおき	人名
おおきひろと	大樹ひろと	人名
おおみねまゆ	大峯麻友	人名
かがみちとせ	鏡ちとせ	人名
かずきまほ	一希真帆	人名
きたみまり	北見毬	人名
きなみちえ	希波千愛	人名
けいかずか	慶一花	人名
ごしきあらた	五色新	人名
さいきたくみ	才樹巧	人名
さくらりこ	桜里湖	人名
さくらぎせいこ	桜木星子	人名
さはらみゆき	早原みゆ紀	人名
さゆきれい	紗幸れい	人名
せいのぼる	勢のぼる	人名
せんだまゆみ	千田真弓	人名
そのおしずく	園生しずく	人名
ちことくるみ	千琴くるみ	人名
ちひろあい	千紘あい	人名
てんどうなぎさ	天道なぎさ	人名
なみねみちる	波音みちる	人名
はるうらら	春うらら	人名
ほしのむつみ	星乃睦実	人名
まきさおり	牧沙織	人名
ましばしゅん	真芝瞬	人名
まちかぜかな	町風佳奈	人名
まつばらみどり	松原碧	人名
みなみかいり	南海里	人名
みねおなな	峰央奈奈	人名
みはまじゅり	美浜寿里	人名
やしおゆうき	八汐佑希	人名
ゆきかぜれい	雪風嶺	人名
よどみやこ	淀都	人名



あいかぜひかる	愛風ひかる	人名
あけぼのまや	曙真八	人名
あさおかなり	麻丘奈里	人名
あさぎみずほ	麻木瑞穂	人名
あさじさき	麻路さき	人名
あさつゆあかり	朝露あかり	人名
あずまみち	東三智	人名
あそうゆみ	麻生由美	人名
あまちひかり	天地ひかり	人名
いずもあや	出雲綾	人名
いちじょうあかね	一城茜	人名
うづきけい	卯月佳	人名
かいきょうひろき	海峡ひろき	人名
かきょうあすか	花鏡あすか	人名
かなちこと	香奈ちこと	人名
かりんいずみ	果林いずみ	人名
かんなみほ	神奈美帆	人名
くぜせいか	久世星佳	人名
くろかわみゆき	黒川深雪	人名
ごだいかつら	醐代かつら	人名
さわきまり	沢木満里	人名
しほうさぎり	紫峯さぎり	人名
しらさぎまどか	白鷺まどか	人名
しらはらかあい	白原可愛	人名
たかつきしょう	鷹月笙	人名
たかねふぶき	高嶺ふぶき	人名
たきはるか	滝はるか	人名
だんひとみ	檀ひとみ	人名
ちあきしん	千秋慎	人名
つくしのあや	筑紫野あや	人名
はなぶさりお	英りお	人名
ひじりますみ	聖真澄	人名
ひとみまりあ	瞳まりあ	人名
ひめまりか	姫まりか	人名
まゆずみれいな	黛れいな	人名
まゆみしずか	真弓しずか	人名
みきさやか	美樹さやか	人名
みずきじゅん	瑞木淳	人名
みつきあゆ	美月亜優	人名
みどりあきえ	翠章江	人名
みわさいこ	美輪さいこ	人名
ゆうまなつき	友麻夏希	人名
わかおりさ	若央りさ	人名
わかなあん	若菜あん	人名



あおぞらはるか	青空はるか	人名
あおみれん	碧海蓮	人名
あかりなみ	灯奈美	人名
あきづきしほ	秋月志保	人名
いつきぎんか	いつき吟夏	人名
おとはらあい	乙原愛	人名
かざみれお	風見玲央	人名
かつらあさひ	桂あさひ	人名
きょうまいこ	今日舞子	人名
くさのめもゆ	草の芽もゆ	人名
くりはられいこ	栗原麗子	人名
ここのえはるか	九重はるか	人名
さわたりみき	沢渡三起	人名
しおねまこと	汐音真実	人名
しのゆか	詩乃優花	人名
せいさきほ	星沙紀帆	人名
だいきゆう	大輝ゆう	人名
たかじょうかのう	高城叶	人名
たかなしじゅん	高梨順	人名
たからぎめり	宝樹芽里	人名
なつおかおり	夏生かおり	人名
なつきまみ	夏妃真美	人名
なつみはるか	夏海はるか	人名
なつみねせん	夏峰千	人名
なつめかな	夏目佳奈	人名
にじぞのはるみ	虹園春美	人名
はごろもらん	羽衣蘭	人名
はなかげみき	花景美妃	人名
はねちさと	羽根知里	人名
ひいろゆかり	日色由佳理	人名
ましろともな	真代朋奈	人名
まつかぜりょう	松風良	人名
まりゆずみ	万里柚美	人名
むらさきとも	紫とも	人名
やよいみつき	弥生みつき	人名
ゆうみさお	悠みさ緒	人名
ゆきはらちなえ	雪原千苗	人名
ゆきむらきょうこ	雪邑響子	人名
らんれいか	蘭玲花	人名
わかきもえ	若木萌	人名
わかくさようこ	若草葉子	人名
わこうはじめ	和光一	人名



あいかみれ	愛華みれ	人名
あかつきなぎさ	暁なぎさ	人名
あさぎりまい	朝霧舞	人名
あゆゆうき	鮎ゆうき	人名
いらかまや	いらか万椰	人名
えなかおる	絵奈かおる	人名
えみわかば	恵美若葉	人名
おおしおますみ	大潮ますみ	人名
おぎしろあやの	荻代彩乃	人名
こうきすばる	光樹すばる	人名
こうさかちあき	香坂千晶	人名
こじかまい	こじか真衣	人名
さえぐさみづき	三枝みづき	人名
さぎくさかおる	鷺草かおる	人名
さわひとみ	沢ひとみ	人名
しおじさよ	潮路小夜	人名
しおりみき	詩織みき	人名
しのはらゆい	篠原ゆい	人名
すみれのあいか	菫乃あいか	人名
せいかさくらこ	聖花桜子	人名
たかやぎみどり	貴柳みどり	人名
たさいしゅん	多彩しゅん	人名
たちばなさえ	橘沙恵	人名
たまきなお	珠木奈緒	人名
ちやあきら	地矢晃	人名
ちょうまいか	蝶まいか	人名
とどろきゆう	轟悠	人名
ともまいか	朋舞花	人名
とわあゆみ	登羽歩	人名
なつかわゆら	夏河ゆら	人名
なみじはるか	浪路はるか	人名
なんきちひろ	南紀ちひろ	人名
のうぶみつこ	能舞三子	人名
はぎおひとみ	萩尾仁美	人名
はくばれい	白馬麗	人名
はなようこ	華陽子	人名
ひょうゆうか	馮裕華	人名
ほたかつゆき	穂高つゆき	人名
まことつばさ	真琴つばさ	人名
まなかひかる	真中ひかる	人名
まりおみつき	毬央みつき	人名
みかさなみ	美夏小波	人名
みのるこう	稔幸	人名
みゆきあかね	美雪茜	人名
ゆうづきみか	夕月美佳	人名
ゆめのちこと	夢乃千琴	人名



あいきしょう	愛輝翔	人名
あかねこのみ	茜このみ	人名
あきのさとみ	秋野里実	人名
あさかげるい	朝景るい	人名
あさかぜゆき	朝風ゆき	人名
あさなあゆみ	朝奈亜弓	人名
いつみねあき	五峰亜季	人名
おうぎちひろ	扇千尋	人名
おうじょうみき	王城美希	人名
おおはらゆうか	大原ゆうか	人名
おおまいかおり	大舞夏織	人名
おおみひろ	大海ひろ	人名
きりはらしょうこ	霧原翔子	人名
くれないかすみ	紅霞	人名
こうじゅたつき	香寿たつき	人名
こしはるき	越はるき	人名
さかきじゅん	榊純	人名
さざなみあい	漣あい	人名
しじょうひかる	紫城輝	人名
しぶきじゅん	紫吹淳	人名
しょうつかさ	翔つかさ	人名
しょうのさき	彰乃早紀	人名
そうだやすこ	宗田靖子	人名
だいしょうかおる	大翔薫	人名
たかちほまい	高千穂舞	人名
たままどか	珠まどか	人名
とおのなおみ	遠野なほみ	人名
なかじょうまり	中条まり	人名
なつまりこ	夏毬子	人名
にしきあい	にしき愛	人名
はやみけい	速水渓	人名
ひのきかおる	檜薫	人名
まおりゆき	真織由季	人名
まやまはる	真山葉瑠	人名
まりおかともみ	毬丘智美	人名
まりなとも	毬菜友	人名
みおれいな	澪れいな	人名
みぐさゆう	美草由布	人名
みしろまり	美城まり	人名
みはらしほ	美原志帆	人名
みやびけい	雅景	人名
もえみせりか	萌水せりか	人名
やぶきしょう	矢吹翔	人名
ゆうびかがり	優美かがり	人名
れいみか	麗美花	人名



あおやまゆきな	青山雪菜	人名
あさおりつき	麻央りつき	人名
あさぶきみなみ	朝吹南	人名
あまじゆか	天路ゆか	人名
あまみゆうき	天海祐希	人名
あやかゆう	彩夏ゆう	人名
いちえりか	一絵梨花	人名
うじょうかおる	卯城薫	人名
えまおゆう	絵麻緒ゆう	人名
おおともれいか	大伴れいか	人名
おづきさゆる	小月さゆる	人名
かいちひろ	甲斐千ひろ	人名
かずひろき	和宏樹	人名
かつらぎななほ	葛城七穂	人名
かのうちほ	叶千穂	人名
かほひかる	花帆ひかる	人名
きたやまりな	北山里奈	人名
ごじょうまい	五条まい	人名
こなみあづさ	木南あづさ	人名
しづきあさと	姿月あさと	人名
しゅみちる	朱未知留	人名
しらほまり	白帆まり	人名
そのななみ	苑ななみ	人名
たいがれん	大河れん	人名
たかゆうき	鷹悠貴	人名
たくみひびき	匠ひびき	人名
ちとせまなぶ	千歳まなぶ	人名
なつしろれい	夏城令	人名
にじょうゆずる	二条ゆずる	人名
のぞみけい	希佳	人名
はましおか	浜汐花	人名
はまかぜあい	浜風愛	人名
ひろきさち	広希さち	人名
まつなみみつる	松波美鶴	人名
まりかなみ	毬花なみ	人名
みすずりりか	美鈴りり花	人名
みちあかり	路あかり	人名
みなときらら	湊きらら	人名
もりおかずみ	森央かずみ	人名
もろとりあい	諸鳥あい	人名
ゆうみれお	有未れお	人名
ゆきのまりえ	雪乃まり絵	人名



あきじしのぶ	秋路しのぶ	人名
あさきゆい	麻希ゆい	人名
あさのかよ	麻乃佳世	人名
あすかいまり	飛鳥井まり	人名
あんじょうありさ	安城ありさ	人名
うたぶえたつき	詩笛立季	人名
おおぞらみか	大空みか	人名
かずさまひろ	一紗まひろ	人名
かもうらら	加茂うらら	人名
かんだとも	神田智	人名
きづきあゆむ	貴月あゆむ	人名
きょうごくあやの	京極彩之	人名
こうづきまり	香月麻里	人名
こじょうらん	湖城蘭	人名
さがのゆり	嵯峨野ゆり	人名
さつきふたば	五月ふたば	人名
しおかぜこう	汐風幸	人名
しのぶむらさき	しのぶ紫	人名
しほうあけの	紫鳳あけの	人名
しらきあやか	白城あやか	人名
すずさとゆうか	涼里有花	人名
すずねりら	鈴音りら	人名
たちきみえ	立木みえ	人名
ときゆうか	時由布花	人名
なぎさあき	渚あき	人名
ななみひかる	七海光	人名
はつかぜみどり	初風緑	人名
はなおかみゆき	花丘美幸	人名
はなぞのゆかり	花園ゆかり	人名
はやせしょうま	はやせ翔馬	人名
ひみやれいこ	妃宮玲子	人名
ふたばかれん	二葉かれん	人名
ほづきみお	帆月みを	人名
まいじはるか	舞路はるか	人名
まちありさ	真地ありさ	人名
まつだいらるび	松平瑠美	人名
みさとまや	美郷真也	人名
みずしろなつみ	水城なつみ	人名
みみあんり	美々杏里	人名
もりなみはる	森奈みはる	人名
わおようか	和央ようか	人名



あいはらせりか	逢原せりか	人名
あきよしあかね	秋吉あかね	人名
あやひろみ	彩ひろみ	人名
あやとれな	彩斗れな	人名
いおりなおか	伊織直加	人名
いぶきかず	伊吹和	人名
おおなつしづき	大夏しづき	人名
かおりゆたか	香織ゆたか	人名
かさいひとみ	花彩ひとみ	人名
かずきせい	一季星	人名
かみやゆき	神矢夕紀	人名
きしろみき	貴代光紀	人名
きりしまるか	桐島るか	人名
くさなぎゆき	草凪佑季	人名
くじょうあきら	久城彬	人名
こづきわたる	湖月わたる	人名
しきかおる	四季香	人名
じゅんあつき	純あつき	人名
たかくらきょう	高倉京	人名
たからぎあや	宝樹彩	人名
ちしろみき	千城美希	人名
なかはらくれあ	中原くれあ	人名
なつのさき	那津乃咲	人名
はなえまち	花会真地	人名
ふじしろまき	藤代真希	人名
まいおつばさ	舞央つばさ	人名
まそのありす	真園ありす	人名
まりさひとみ	万理沙ひとみ	人名
みさきすずな	美咲すずな	人名
みずきあい	みずき愛	人名
みずほたまき	瑞穂環	人名
みそのえりか	美苑えりか	人名
みなづきしずか	水月静	人名
みばえゆうり	実生友里	人名
みほけいこ	美穂圭子	人名
やまぶきさよ	山吹紗世	人名
ゆうきかおる	祐輝薫	人名
よしづきえり	嘉月絵理	人名
わかえゆき	若江由季	人名



あいみやび	亜衣雅	人名
あさくらあおい	朝倉葵	人名
あさみねひかり	朝峰ひかり	人名
あまきかおり	天希かおり	人名
あやきなお	彩輝直	人名
えざきりせ	絵咲利瀬	人名
おうなみつばさ	欧波翼	人名
おおがあゆみ	大雅歩	人名
おおひろあゆむ	大洋あゆ夢	人名
おかかずみ	丘和巳	人名
おときみか	音木美香	人名
かえでさき	楓沙樹	人名
かざとゆま	風人夕真	人名
かざはなまい	風花舞	人名
かざはやゆう	風早優	人名
こちょうあすか	胡蝶明日香	人名
ことぶきつかさ	寿つかさ	人名
さがみれい	沙加美怜	人名
さちみあんな	幸美杏奈	人名
じゅりさきほ	樹里咲穂	人名
じゅんなりさ	純名里沙	人名
すずなさや	鈴奈沙也	人名
すずなみお	鈴奈美央	人名
たかしょうみずき	高翔みず希	人名
たかむれあゆ	高牟礼あゆ	人名
ちなみゆう	千波ゆう	人名
つきかげひとみ	月影瞳	人名
なしろあおい	名城あおい	人名
はづきれい	葉月れい	人名
ほしなゆり	星奈優里	人名
ほしのひとみ	星野瞳	人名
ましおいづる	真汐いづる	人名
まなみしほ	万波紫帆	人名
まゆかれお	真由華れお	人名
まよさくら	麻世さくら	人名
まりあいひとみ	毬愛ひとみ	人名
みどりはなか	翠花果	人名
ゆうやなほ	悠矢奈穂	人名
りょうあきの	陵あきの	人名
るなまり	瑠菜まり	人名



あきみずほ	安岐みずほ	人名
あきらかずき	彰かずき	人名
あさぞのみき	麻園みき	人名
あさぞらりほ	朝空理帆	人名
あさみひかる	朝海ひかる	人名
あさみやまゆ	朝宮真由	人名
あまみやもえ	天宮萌	人名
あらんけい	安蘭けい	人名
ありさみほ	有沙美帆	人名
かほうゆりか	香宝ゆりか	人名
きたじままみ	北嶋麻実	人名
さくらぎえみ	桜木絵美	人名
しおみまほ	汐美真帆	人名
じょうかあづき	城華阿月	人名
しらとりゆりえ	白鳥ゆりえ	人名
すずかけみゆき	鈴懸三由岐	人名
すばるかずき	昴一輝	人名
せいやゆう	聖矢優	人名
たかおりお	高央りお	人名
つづしろあい	都々城あい	人名
つぶらひとみ	都布良ひとみ	人名
ななせかい	七瀬快	人名
なるせこうき	成瀬こうき	人名
ののみるて	野乃みるて	人名
はなふさまり	花總まり	人名
はらみてき	原美笛	人名
はるのすみれ	春野寿美礼	人名
ひびやめぐみ	日比谷恵	人名
ふたばみき	双葉美樹	人名
ほなみありあ	穂波亜莉亜	人名
まいねあずさ	舞音梓	人名
まきめぐみ	真樹めぐみ	人名
まさおかなお	真丘奈央	人名
まほろばゆう	まほろば遊	人名
みすぎちか	三杉千佳	人名
みずしまあおい	水島あおい	人名
みなみしずか	南しずか	人名
ゆうなおき	悠なお輝	人名
ゆうかえり	優花えり	人名
ゆきわかな	雪わかな	人名



あかさかみき	赤坂実樹	人名
あさだこう	麻田こう	人名
あまのゆか	天乃悠華	人名
あやぞのゆき	彩苑ゆき	人名
あやなまい	綾奈舞	人名
あんのりょう	安野凌	人名
うたはなゆみ	歌花由美	人名
おおぞらゆうひ	大空祐飛	人名
おおたかつばさ	大鷹つばさ	人名
おとわりょう	音羽椋	人名
かいほうたまき	海宝珠起	人名
かじゆうき	華路ゆうき	人名
きみともか	公智香	人名
けいなつき	渓なつき	人名
しづきこう	紫月光	人名
しらんますみ	紫蘭ますみ	人名
せなじゅん	瀬奈じゅん	人名
そのみやれいな	苑宮令奈	人名
たかしろけい	貴城けい	人名
だんれい	檀れい	人名
ちひろれいか	千紘れいか	人名
つかさゆうき	司祐輝	人名
なつかぜりお	夏風りお	人名
ななまりか	奈々まりか	人名
はずみるい	羽純るい	人名
はなさきりか	花咲里香	人名
はなづきあや	華月あや	人名
はなぶきまい	花吹まい	人名
はるなりお	遥奈りお	人名
ひとみりか	瞳里佳	人名
ひびきまりあ	響まりあ	人名
ひろみよし	裕三佳	人名
ほだかゆう	穂高ゆう	人名
まおなつき	真於夏希	人名
まゆづきこう	眉月凰	人名
みずほのせいか	水穂野清香	人名
みやすあり	美夜寿安里	人名
ゆうきまお	夕貴真緒	人名
ゆうなあき	夕奈あき	人名
ゆめきのあ	夢輝のあ	人名



あいようこ	愛耀子	人名
あいきしゅり	愛希朱里	人名
あいみりせ	愛海理世	人名
あかねみつき	茜みつ希	人名
あきそのみお	秋園美緒	人名
あさひなけい	朝比奈慶	人名
あづさまりん	亜づさ真鈴	人名
あやさきなるみ	綾咲成美	人名
あやせさき	彩勢沙樹	人名
あゆかわなつき	鮎川夏来	人名
ありかじゅん	有香潤	人名
えりちあき	絵莉千晶	人名
おおとりれい	大鳥れい	人名
かざきまや	風輝マヤ	人名
かざほゆうり	風帆優里	人名
きくほりな	菊穂りな	人名
きさきみり	貴咲美里	人名
きたはらりま	北原里麻	人名
こうすずか	幸涼香	人名
こうのまりか	香乃毬花	人名
こしのりゅう	越乃リュウ	人名
こまりなな	小毬なな	人名
さえづきあきら	冴月晃	人名
さきのぞみ	さき望実	人名
さくまゆき	佐久真ゆき	人名
たいじゅまき	大樹槙	人名
たかせゆう	貴瀬ゆう	人名
たつつかさ	達つかさ	人名
たつきよう	立樹遥	人名
まさきかずさ	柾輝かずさ	人名
みきちぐさ	美稀千種	人名
みずなつき	水夏希	人名
みずたにしの	水谷紫乃	人名
みずはらまどか	水原まどか	人名
みちきよら	路きよら	人名
みなしろひかり	南城ひかり	人名
みらいゆうき	未来優希	人名
むこあゆむ	武庫歩	人名
むつきまお	夢月真生	人名
りりせいら	莉理せいら	人名



あいだめぐ	愛田芽久	人名
あきづきしょう	秋月章	人名
あさぎゆうな	あさぎ裕南	人名
あさずみけい	朝澄けい	人名
あさまもゆ	麻真もゆ	人名
あやぶきまお	彩吹真央	人名
あゆらかお	あゆら華央	人名
あんりみちる	杏里ミチル	人名
かずゆうと	一優斗	人名
かのんしおり	花暢しおり	人名
きりやひろむ	霧矢大夢	人名
くおんまや	久遠麻耶	人名
くじあかり	久路あかり	人名
すがたこう	すがた香	人名
せんほさち	千ほさち	人名
たまきかほ	珠希かほ	人名
なづきみか	奈月みか	人名
なつほあきら	夏帆輝	人名
なみきあきら	波輝晶	人名
なるみじゅん	鳴海じゅん	人名
はつねまよ	初嶺まよ	人名
はやせあゆ	早瀬鮎	人名
はるあゆか	春あゆか	人名
はるかいっき	春鹿一輝	人名
ひしょうゆう	飛翔夕	人名
ふぶきあゆ	風吹あゆ	人名
まいはなきょう	舞花京	人名
ますみうらら	真澄うらら	人名
またけすぐる	真竹すぐる	人名
まりほえりな	毬穂えりな	人名
みずさわはづき	水沢葉月	人名
みなせあお	水瀬あお	人名
みなほかりん	南帆香凜	人名
みやえりか	美椰エリカ	人名
むらさきのゆき	紫野ゆき	人名
めいかれん	芽衣かれん	人名
ももかさり	百花沙里	人名
ゆうきまゆ	結輝真由	人名
ゆめなさや	夢奈さや	人名



あやどりかんな	彩鳥かんな	人名
あやめひかる	彩愛ひかる	人名
いっしきるか	一色瑠加	人名
えれまりな	絵麗まりな	人名
おうかれいや	桜花れいや	人名
かおうれみ	花央レミ	人名
かざみよしき	風美佳希	人名
かじかくみ	梶花空未	人名
かすみふうか	花純風香	人名
かぜおいぶき	風緒いぶき	人名
けいじゅまな	京樹真那	人名
そのみかげ	苑みかげ	人名
たかはねうきょう	貴羽右京	人名
ちぐさことみ	千草ことみ	人名
つばきひろか	椿火呂花	人名
にじのゆめか	虹乃夢果	人名
はつきかなで	初輝奏	人名
はなかげみさき	華景みさき	人名
はなせみずか	花瀬みずか	人名
ひさとりえ	妃里梨江	人名
ふづきみよ	ふづき美世	人名
ほさきりんな	帆咲りんな	人名
まいかぜりら	舞風りら	人名
まちかめぐる	麻愛めぐる	人名
まつゆきかなこ	松雪可奈子	人名
まどかさくら	円さくら	人名
まとぶせい	真飛聖	人名
まりなみほ	毬奈みほ	人名
みたかのぞみ	美高望	人名
みつみあきほ	光海晶帆	人名
みもりさやか	美森さやか	人名
やまとゆうが	大和悠河	人名
ゆうまりん	悠真倫	人名
ゆきじかほ	雪路歌帆	人名
ゆめだいき	夢大輝	人名
ゆめさきみのり	夢咲みのり	人名
ゆめじほのか	夢路ほのか	人名
ゆりかしほ	ゆり香紫保	人名
よしのきょうか	美乃杏花	人名
らんかれあ	蘭香レア	人名



らんじゅとむ	蘭寿とむ	人名
すずみしお	涼紫央	人名
こんのまひる	紺野まひる	人名
さいじょうみえ	西條三恵	人名
あおみたく	蒼海拓	人名
ななみさら	七海さら	人名
くすのきけいか	楠恵華	人名
まりのゆい	毬乃ゆい	人名
たちばなりや	橘梨矢	人名
ひだかきら	斐貴きら	人名
りょうがはるひ	遼河はるひ	人名
そうかずほ	壮一帆	人名
すずのかつき	涼乃かつき	人名
みかぜまいら	美風舞良	人名
ひめこだま	姫こだま	人名
めむちさと	芽夢ちさと	人名
みすみかのん	水純花音	人名
さわきくるみ	沢樹くるみ	人名
ちはやまえ	千早真永	人名
まいさかゆきこ	舞坂ゆき子	人名
あやかぜらん	彩風蘭	人名
たかきあまね	良基天音	人名
けんるいす	研ルイス	人名
みねけいと	嶺恵斗	人名
はなみやあいり	華宮あいり	人名
かのうちか	叶千佳	人名
はやみりき	速水リキ	人名
みずしろれな	水城レナ	人名
つきふねさらら	月船さらら	人名
さえきせいや	冴輝星也	人名
ほしかぜえれな	星風エレナ	人名
あさかせれな	麻夏せれな	人名
つきおかななお	月丘七央	人名
あゆなさえ	鮎奈さえ	人名
みひろせいさ	未宙星沙	人名
しろかこゆ	白樺湖夕	人名
あおぞらやひろ	青空弥ひろ	人名
きのことせ	輝乃琴星	人名



あませいづる	天勢いづる	人名
あやのかなみ	彩乃かなみ	人名
みおうらら	澪うらら	人名
しじょうるい	紫城るい	人名
こいずみきらら	湖泉きらら	人名
あいねはれい	愛音羽麗	人名
たくまさき	拓麻早希	人名
あさないるみ	朝菜いるみ	人名
すずはらんの	涼葉らんの	人名
あもうたまき	天羽珠紀	人名
なつめりん	夏芽凛	人名
はなきゆいな	花綺ゆいな	人名
ことまりえ	琴まりえ	人名
ひいろもえ	陽色萌	人名
ゆうみひろ	悠未ひろ	人名
ゆうほさとる	祐穂さとる	人名
まみやゆき	眞宮由妃	人名
みずのちはる	水野ちはる	人名
ほうじゅこなつ	宝珠小夏	人名
しらかわるり	白河るり	人名
ひじりれい	聖れい	人名
まきせかい	牧勢海	人名
ほうじょうるみ	宝生ルミ	人名
みづきまい	水月舞	人名
なつひろみ	夏大海	人名
れいゆうき	玲有希	人名
つきしろみさき	月城美咲	人名
ちさきまりあ	千咲毬愛	人名
すずはるき	珠洲春希	人名
あやねえいか	彩音瑛花	人名
たかみりょう	貴水りょう	人名
しまあらた	紫万新	人名
はおとりの	葉音りの	人名
ふうがみなと	風雅湊	人名
ましおしん	真汐薪	人名
みふねせいか	美舟星河	人名
あんじょうしき	安城志紀	人名
れんじょうるな	蓮城ルナ	人名
もえきあやと	萌希彩人	人名
たつみきわ	巽希和	人名



せんどうかほ	仙堂花歩	人名
めばえはるか	芽映はるか	人名
あさきゆめみ	麻樹ゆめみ	人名
おとづきけい	音月桂	人名
まいしろのどか	舞城のどか	人名
たかみやちなつ	高宮千夏	人名
かざりじん	風莉じん	人名
みすずあき	未涼亜希	人名
とおのあすか	遠野あすか	人名
ほくしょうかいり	北翔海莉	人名
しいなあおい	椎名葵	人名
しおかゆりさ	汐夏ゆりさ	人名
おりかなるみ	織花なるみ	人名
せおみつき	瀬央みつき	人名
はなえみく	華絵みく	人名
おおまみらん	大真みらん	人名
かじょうありあ	花城アリア	人名
きりゅうそのか	桐生園加	人名
たかれいら	貴怜良	人名
あそうあくら	麻生あくら	人名
まきかおる	真木薫	人名
くろさわだりあ	黒澤だりあ	人名
うしおわか	潮和歌	人名
はやぶささつき	隼颯希	人名
きぶねなお	貴船尚	人名
ゆめぞのまい	夢園麻衣	人名
りょうまとも	涼麻とも	人名
あやかれい	綺華れい	人名
さわねかずき	沢音和希	人名
たいがむつみ	大河睦	人名
しらはねゆり	白羽ゆり	人名
ゆきなつぐみ	雪菜つぐみ	人名
ちことひめか	千琴ひめか	人名
あさぶきゆいか	麻吹由衣加	人名
たかとおあずさ	高遠梓	人名
ほすみさえ	甫純冴	人名
なつおこまき	夏央小槇	人名
みしろれん	美城れん	人名
さわまなほ	沙和真奈帆	人名



みほうあや	美鳳あや	人名
ゆずきれおん	柚希礼音	人名
みわあさひ	美羽あさひ	人名
さくらいちか	桜一花	人名
おときすなお	音姫すなお	人名
かみづきあかね	神月茜	人名
たかみやりな	高宮里菜	人名
ななせきら	七星きら	人名
まいさきりん	舞咲りん	人名
すずしろまりな	涼城まりな	人名
えみくらら	映美くらら	人名
そうのはると	奏乃はると	人名
やましなあい	山科愛	人名
ななほひかる	七帆ひかる	人名
まのすがた	真野すがた	人名
もりさきかぐや	森咲かぐや	人名
ましろふあり	真白ふあり	人名
しきぶいろは	式部いろは	人名
はながたひかる	華形ひかる	人名
じんれいか	神麗華	人名
あまぎりまよ	天霧真世	人名
あおきいずみ	青樹泉	人名
うめぞのさち	梅園紗千	人名
おとのいづみ	音乃いづみ	人名
はづきさら	葉月さら	人名
みなみまり	南海まり	人名
おおみあこ	大海亜呼	人名
はなぎりわかな	華桐わかな	人名
はなもりまゆり	花森まゆり	人名
ときいりす	十輝いりす	人名
こさきひより	湖咲ひより	人名
てんしょうゆうり	天翔ゆうり	人名
ぎんがあみ	銀河亜未	人名
かほあんな	花帆杏奈	人名
みねきあやと	嶺輝あやと	人名
あやなおと	彩那音	人名
あまのほたる	天野ほたる	人名
じゅんあいら	純あいら	人名
ひいらぎともえ	柊巴	人名
おとせしゅか	音瀬朱夏	人名



あやみはや	彩海早矢	人名
かずりょうか	和涼華	人名
みねかひさり	峰華ひさり	人名
そらきれいか	宙輝れいか	人名
こじょうゆきの	湖城ゆきの	人名
もちづきりせ	望月理世	人名
とうかゆりの	憧花ゆりの	人名
まなみそら	真波そら	人名
ひづきはな	陽月華	人名
あゆせみと	鮎瀬美都	人名
しろさきあい	城咲あい	人名
たままゆら	珠まゆら	人名
なつきれお	夏輝れお	人名
あまおけいか	天緒圭花	人名
まいなりおん	舞名里音	人名
あやはなちか	綾花ちか	人名
せいじょうかいと	星条海斗	人名
りんかせら	凜華せら	人名
かわいみずほ	花愛瑞穂	人名
おうきかなめ	凰稀かなめ	人名
せいのかじゅ	聖野花珠	人名
はなみゆうか	華美ゆうか	人名
しほうななみ	紫峰七海	人名
しきえりお	姿樹えり緒	人名
あいのりほ	愛野りほ	人名
はなのじゅりあ	花野じゅりあ	人名
かずきしん	一輝慎	人名
あさくらももこ	麻倉ももこ	人名
ほづきはるな	穂月はるな	人名
あおばみちる	青葉みちる	人名
はるみおおら	遥海おおら	人名
おづきとおま	緒月遠麻	人名
みことさなえ	美琴さなえ	人名
すずはなりさ	涼花リサ	人名
なつぞらももみ	夏空李光	人名
ひほうこころ	妃鳳こころ	人名
はつせゆか	初瀬有花	人名
くさなぎもえ	草凪萌	人名
あさぎりしの	朝桐紫乃	人名
つきじかなで	月路奏	人名
たにみずせ	谷みずせ	人名
はなおからら	華岡らら	人名
てんがゆうと	天河佑斗	人名



るねまいか	瑠音舞佳	人名
さおうくらま	沙央くらま	人名
かしろきほ	華城季帆	人名
つるみまゆう	鶴美舞夕	人名
みゆめひまり	美夢ひまり	人名
おとはなゆり	音花ゆり	人名
しみずきょうか	紫水梗華	人名
かずねみおう	和音美桜	人名
やくもみか	八雲美佳	人名
はるかみどり	晴華みどり	人名
あやづきせり	綾月せり	人名
あやはしみゆ	彩橋みゆ	人名
もえかゆりあ	萌花ゆりあ	人名
しらほりん	白帆凜	人名
さきはなあん	咲花杏	人名
みなほさり	南帆サリ	人名
せいきはんな	星紀はんな	人名
はつひめさあや	初姫さあや	人名
さぎりせいな	早霧せいな	人名
ゆめのせいか	夢乃聖夏	人名
みさきれい	岬麗	人名
おとみゆうま	音海ゆうま	人名
ひなたさん	日向燦	人名
まいはめぐみ	舞羽恵	人名
はなおこのみ	花緒このみ	人名
しようれね	紫陽レネ	人名
みまきさきょう	美牧冴京	人名
かのせいや	華乃星矢	人名
まりきとわ	鞠輝とわ	人名
しらとりかすが	白鳥かすが	人名
りゅうまさき	龍真咲	人名
かりんもゆる	華凜もゆる	人名
えのきとうや	榎登也	人名
ともかしゅり	朋夏朱里	人名
まとうかなた	真灯かなた	人名
あつきれんか	麻月れんか	人名
いさきまおと	衣咲真音	人名
あやみづき	彩みづ希	人名
じゅんかまりい	純花まりい	人名
ちひろゆう	千尋悠	人名
くさかぜなな	草風なな	人名
しおうみやび	姿央みやび	人名



おおなぎまお	大凪真生	人名
ななかぜうみ	七風宇海	人名
ゆめかあやり	夢華あやり	人名
はざきまな	羽咲まな	人名
はなののみ	花ののみ	人名
ゆうずみしゅん	祐澄しゅん	人名
こうづきるう	光月るう	人名
はるかぜみさと	春風弥里	人名
かようきらり	華耀きらり	人名
あさかまなと	朝夏まなと	人名
おうぎめぐむ	扇めぐむ	人名
さくらのあやね	桜乃彩音	人名
さはなまこ	早花まこ	人名
はなつゆすみか	花露すみか	人名
あさはなりんか	麻華りんか	人名
あいずみもえり	愛純もえり	人名
かげつみやこ	夏月都	人名
みずきりょう	水輝涼	人名
むらさきいつみ	紫いつみ	人名
はむろちあり	葉室ちあ理	人名
つきおかずさ	月央和沙	人名
しゆうみれい	紫友みれい	人名
はなそのみゆう	華苑みゆう	人名
はすみゆうや	蓮水ゆうや	人名
まおうあきと	真央あきと	人名
あおいふぶき	葵吹雪	人名
ゆうきせんじゅ	祐輝千寿	人名
あやねらいら	綾音らいら	人名
あやおじゅね	彩央寿音	人名
せいかまい	聖花まい	人名
まひろしゅん	麻尋しゅん	人名
はなかげありす	花影アリス	人名
だいごせしる	大湖せしる	人名
ほうしょうだい	鳳翔大	人名
まあさひとみ	真麻ひとみ	人名
ひさきせあら	妃咲せあら	人名
つづみえいか	鼓英夏	人名
せんはふり	千はふり	人名
ゆうぎりらい	夕霧らい	人名
かおあみり	華央あみり	人名
さいかりょう	彩夏涼	人名
しずかちな	雫花ちな	人名
さらんえりか	紗蘭えりか	人名
あさねさつと	麻音颯斗	人名
やしおゆうみ	八汐ゆう美	人名
となんさきら	斗南さきら	人名
くれないゆずる	紅ゆずる	人名
おりよしの	織佳乃	人名



あいきゆま	愛輝ゆま	人名
あいさもも	愛紗もも	人名
あいはなちさき	愛花ちさき	人名
あおみりま	碧海りま	人名
あかつきごう	暁郷	人名
あすみりお	明日海りお	人名
あまみやなお	天宮菜生	人名
あもんまち	亜門真地	人名
いすずひかり	五十鈴ひかり	人名
いちじょうあずさ	壱城あずさ	人名
うらきひろと	浦輝ひろと	人名
おおつきさゆ	大月さゆ	人名
おうじゅひらり	桜寿ひらり	人名
かおんゆうき	香音有希	人名
かしょうなおと	香翔なおと	人名
きさきひなの	姫咲ひなの	人名
ここまりあ	湖々マリア	人名
さつきあいな	沙月愛奈	人名
さわきりず	沢希理寿	人名
じゅんやちとせ	純矢ちとせ	人名
しらはなれみ	白華れみ	人名
しらみねさゆり	白峰さゆり	人名
すずせみうと	涼瀬みうと	人名
なぎなるうみ	凪七瑠海	人名
ななみひろき	七海ひろき	人名
なるかまりん	成花まりん	人名
のぞみふうと	望海風斗	人名
はさぎつばさ	羽鷺つばさ	人名
はざくらしずく	羽桜しずく	人名
はつきよしや	初輝よしや	人名
はなかゆりん	花夏ゆりん	人名
はなさきりりか	花咲りりか	人名
はなづきゆま	華月由舞	人名
はるなひとみ	遥奈瞳	人名
ひのあんじ	妃乃あんじ	人名
ひみやさくら	妃宮さくら	人名
まいきあゆみ	舞姫あゆみ	人名
まいやりり	舞椰莉々	人名
まりむらかおる	茉莉邑薫	人名
みおのせいら	澪乃せいら	人名
みしょうかずき	美翔かずき	人名
みねのかずま	嶺乃一真	人名
みやるりか	美弥るりか	人名
みやびおうか	雅桜歌	人名
もえのりりあ	萌野りりあ	人名
ゆずのれいか	柚乃玲花	人名
ゆめさきねね	夢咲ねね	人名
りゅうきかずと	流輝一斗	人名
れんじょうまこと	蓮城まこと	人名



あいはらみか	愛原実花	人名
あおのゆき	蒼乃夕妃	人名
あさかぜれい	朝風れい	人名
あさとまお	朝都まお	人名
あさなぎまな	朝凪麻名	人名
あずさはるき	梓晴輝	人名
あまかぜいぶき	天風いぶき	人名
あやしろれあ	彩城レア	人名
あやはねまや	彩羽真矢	人名
あやほしりおん	彩星りおん	人名
うづきはやて	宇月颯	人名
うめさきいぶ	梅咲衣舞	人名
おうかれの	凰華れの	人名
かいはやと	海隼人	人名
かいどうのぞむ	海桐望	人名
かざねまゆき	風音まゆき	人名
かざはねれいあ	風羽玲亜	人名
かのんまい	花音舞	人名
かほうしおり	夏鳳しおり	人名
かりょうしずる	香綾しずる	人名
きさらぎれん	如月蓮	人名
こうがあさひ	煌雅あさひ	人名
こうみまいと	光海舞人	人名
ことねかずは	琴音和葉	人名
ことはさくらこ	琴羽桜子	人名
さえづきるな	冴月瑠那	人名
さくまたかね	咲真たかね	人名
しおつきしゅう	汐月しゅう	人名
しろたえなつ	白妙なつ	人名
すずねりょう	寿々音綾	人名
せいがりょう	聖河椋	人名
せとかずや	瀬戸かずや	人名
ちかぜかれん	千風カレン	人名
ちすずまゆ	千鈴まゆ	人名
ときわみづの	常盤みづの	人名
なおきじゅん	直樹じゅん	人名
なつしろらんか	夏城らんか	人名
はなかぜみらい	花風みらい	人名
ひとみゆゆ	瞳ゆゆ	人名
ひびきれおな	響れおな	人名
ほうじゅいち	鳳樹いち	人名
みかげりん	美影凜	人名
みずはかなと	瑞羽奏都	人名
みなかぜりな	南風里名	人名
めぶきゆきな	芽吹幸奈	人名
ゆうづきれな	悠月れな	人名
ゆうなはやき	悠南はやき	人名
よしのほのか	美乃ほのか	人名
りょうかぐら	遼かぐら	人名
れみくれあ	玲実くれあ	人名



あいみせれな	愛水せれ奈	人名
あうらまき	あうら真輝	人名
あやさきめい	彩咲めい	人名
あやせあきな	綾瀬あきな	人名
ありせそう	有瀬そう	人名
うたかぜすい	詩風翠	人名
うららもえ	麗百愛	人名
おうがみつき	央雅光希	人名
おおきまこと	大輝真琴	人名
おおとりまゆ	鳳真由	人名
おとはみのり	音波みのり	人名
かちょうしほ	花蝶しほ	人名
かなきょうこ	花菜響子	人名
かなみかり	華那みかり	人名
きせみらの	希世みらの	人名
きとりまりや	稀鳥まりや	人名
きらまさと	輝良まさと	人名
ことしろまなか	琴城まなか	人名
このはないのり	此花いの莉	人名
さえきちはや	冴輝ちはや	人名
さきあかね	咲希あかね	人名
ささらえる	笹良える	人名
しざきひろか	紫咲大佳	人名
しもんゆりや	紫門ゆりや	人名
しらきあかり	白姫あかり	人名
しらなぎすず	白渚すず	人名
しらゆきさちか	白雪さち花	人名
しんげつさく	真月咲	人名
すみきさやと	澄輝さやと	人名
せんじゅはる	千寿はる	人名
そうまねお	颯舞音桜	人名
たかちあお	貴千碧	人名
たかむらゆうき	篁祐希	人名
てんじゅみつき	天寿光希	人名
てんれいみおん	天玲美音	人名
とうまかずき	透真かずき	人名
ののすみか	野々すみ花	人名
はなさとまな	花里まな	人名
はなみねちはる	花峰千春	人名
はるさきころん	春咲ころん	人名
はるはなきらら	春花きらら	人名
ひなづきおとは	雛月乙葉	人名
ふじさきえり	藤咲えり	人名
まいかくるみ	舞花くるみ	人名
まさぶきみのり	真吹みのり	人名
まなかあゆ	愛加あゆ	人名
ゆうかりこ	優香りこ	人名



あいなゆうり	愛那結梨	人名
あきづきさや	煌月爽矢	人名
あまきとにか	天輝トニカ	人名
あまさきちはな	天咲千華	人名
あやなぎしょう	彩凪翔	人名
あんりまう	安里舞生	人名
おおすみれい	大澄れい	人名
かずさよしき	神房佳希	人名
きざきれお	輝咲玲央	人名
きづきみれい	貴月美礼	人名
ぎんかすい	銀華水	人名
けんざきゆうか	剣崎裕歌	人名
さはねゆな	紗羽優那	人名
しづきおとね	紫月音寧	人名
しょうのちお	笙乃茅桜	人名
しらゆりひめ	白百合ひめ	人名
すみれのれい	すみれ乃麗	人名
せきゆりと	瀬稀ゆりと	人名
たかすみはやと	貴澄隼人	人名
ちなみからん	千海華蘭	人名
ちされいな	千紗れいな	人名
つきえじゅま	月映樹茉	人名
つきのひめか	月野姫花	人名
てんまみちる	天真みちる	人名
とうみさらさ	透水さらさ	人名
はつはなみさき	初花美咲	人名
はなおりちさ	花織千桜	人名
はなしろまい	花城舞	人名
はなきまほ	花輝真帆	人名
ひしろゆあ	妃白ゆあ	人名
ひだかだいち	日高大地	人名
ふうりみずか	風凛水花	人名
ほうづきあん	鳳月杏	人名
ほんじょうくれは	本城くれは	人名
まあいすずか	真愛涼歌	人名
まいのゆか	舞乃ゆか	人名
まかぜすずほ	真風涼帆	人名
まつかぜあきら	松風輝	人名
まなはると	真那春人	人名
まなせはるか	真瀬はるか	人名
まりかゆめ	鞠花ゆめ	人名
みはるあやか	美春あやか	人名
ももはなひな	桃花ひな	人名
ももちいと	百千糸	人名
ゆめりみこ	夢莉みこ	人名
らんのはな	蘭乃はな	人名
りんじょうきら	凛城きら	人名
わかなつあやめ	若夏あやめ	人名



あいしろもあ	愛白もあ	人名
あいづきひかる	愛月ひかる	人名
あせいいつき	亜聖樹	人名
あやかぜさきな	彩風咲奈	人名
おうさきあやか	桜咲彩花	人名
おうしなゆう	凰姿有羽	人名
かざみけいと	風海恵斗	人名
きじょうみつる	輝城みつる	人名
さなゆずは	紗那ゆずは	人名
さほゆかり	桜帆ゆかり	人名
さやかしおん	彩歌しおん	人名
しょうがつばき	翔我つばき	人名
すずらんまあや	鈴蘭まあや	人名
せおとりさ	瀬音リサ	人名
せりかとあ	芹香斗亜	人名
そらのみゆ	空乃みゆ	人名
そらはねりく	蒼羽りく	人名
たいがりん	大河凜	人名
たまはなゆふ	珠華ゆふ	人名
ちせひじり	千瀬聖	人名
つづきみあ	都月みあ	人名
とあれいや	十碧れいや	人名
なぎさせいな	凪咲星南	人名
なつきれい	夏樹れい	人名
ななくらら	菜那くらら	人名
ななせりりこ	七瀬りりこ	人名
はななみお	花奈澪	人名
はなひみら	花陽みら	人名
はなぶきのあ	華吹乃愛	人名
ほうりゅうあや	鳳龍あや	人名
ほかぜなるみ	帆風成海	人名
ほしきつばさ	星輝つばさ	人名
ほしなゆたか	星那由貴	人名
ほしぶきあやと	星吹彩翔	人名
まいそのるり	舞園るり	人名
まいはねみみ	舞羽美海	人名
まおんきあら	舞遠きあら	人名
まきいづみ	真輝いづみ	人名
まりんかんな	真凛カンナ	人名
みずせちあき	水瀬千秋	人名
みそらかれん	美宙果恋	人名
みはなりの	美花梨乃	人名
ゆいのかなり	結乃かなり	人名
ゆきのここみ	雪乃心美	人名
ゆめきあんる	夢妃杏瑠	人名
ゆめしろえれん	夢城えれん	人名
ゆめすずりあん	夢涼りあん	人名
りんかもえ	凜華もえ	人名
るどうまさ	琉動真瑳	人名
わたるひびき	航琉ひびき	人名



あいかぜゆめ	愛風ゆめ	人名
あいさきまりあ	愛咲まりあ	人名
あさひみらい	朝陽みらい	人名
あまとりいら	天翔りいら	人名
あまねさら	天舞音さら	人名
あんのこのみ	杏野このみ	人名
かがりりか	華雅りりか	人名
かがみせいや	輝海せいや	人名
かずみしょう	和海しょう	人名
きらはれお	煌羽レオ	人名
きらみるいせ	煌海ルイセ	人名
くじょうあす	久城あす	人名
こうさきらん	香咲蘭	人名
さえばなりおな	冴華りおな	人名
さおとめわかば	早乙女わかば	人名
さきはなりほ	咲花莉帆	人名
さくらねれい	桜音れい	人名
さざなみれいら	漣レイラ	人名
さちかせいら	紗愛せいら	人名
しのかりあ	紫乃加りあ	人名
しょうまじゅね	翔馬樹音	人名
すばるはなか	寿春花果	人名
せんなあやせ	仙名彩世	人名
たいきりょう	大樹りょう	人名
たかほしゅう	貴穂しゅう	人名
たまきりょう	珠城りょう	人名
にいなかほ	新菜かほ	人名
はなさきあいり	花咲あいり	人名
はやみせい	隼海惺	人名
はりゅうみつき	羽立光来	人名
はるせおうき	春瀬央季	人名
ひなたのかりん	ひなたの花梨	人名
ひゅうがらん	飛河蘭	人名
ふうまかける	風馬翔	人名
ほしづきりお	星月梨旺	人名
まいづきなぎさ	舞月なぎさ	人名
まおゆうき	麻央侑希	人名
まりなまゆ	毬愛まゆ	人名
みずみれい	美泉儷	人名
みつきはるか	美月悠	人名
めいからら	芽華らら	人名
ゆうといりや	悠斗イリヤ	人名
ゆめはみゆ	夢羽美友	人名
ゆめはならん	夢花らん	人名



あいすみれ	愛すみれ	人名
あいはふぶき	愛羽ふぶき	人名
あさおれん	朝央れん	人名
あさみじゅん	朝美絢	人名
あまつきつばさ	天月翼	人名
あやかまり	彩花まり	人名
おうじかおる	桜路薫	人名
おうつりさ	凰津りさ	人名
おうづきあかり	逢月あかり	人名
かえでゆき	楓ゆき	人名
かずしろるな	和城るな	人名
きづきゆうま	輝月ゆうま	人名
ことかちの	こと華千乃	人名
さくらぎみなと	桜木みなと	人名
さももさつき	早桃さつき	人名
しらみねゆり	白峰ゆり	人名
すずかまや	涼華まや	人名
せおゆりあ	瀬央ゆりあ	人名
つきしろかなと	月城かなと	人名
ななおまき	七生眞希	人名
はなえちほ	花瑛ちほ	人名
はるねあき	晴音アキ	人名
ひざくらほのり	妃桜ほのり	人名
ひなみふう	妃海風	人名
ひろかゆう	ひろ香祐	人名
ほしのあんり	星乃あんり	人名
まいひなの	真衣ひなの	人名
まなきれいか	愛希れいか	人名
まほうつぐみ	真鳳つぐみ	人名
まみやすずこ	真みや涼子	人名
みさきりおん	実咲凜音	人名
みさとゆめの	美里夢乃	人名
みなみまいと	水美舞斗	人名
みらんれんな	美蘭レンナ	人名
みれいじゅん	実羚淳	人名
むらさきりら	紫りら	人名
もえぶきまほろ	萌吹まほろ	人名
ゆうひかる	優ひかる	人名
ゆきはなさくら	雪華さくら	人名
ゆずかれい	柚香光	人名
るみじゅん	留美絢	人名
れいまこと	礼真琴	人名
れいなゆう	麗奈ゆう	人名
れいみうらら	伶美うらら	人名
れんじゅこうき	蓮珠こうき	人名



あおいみき	蒼井美樹	人名
あかねこなつ	茜小夏	人名
あきねひかる	秋音光	人名
あさづききわ	朝月希和	人名
あさみずりょう	朝水りょう	人名
おういぶき	凰いぶき	人名
おうましおん	桜舞しおん	人名
おとさきいつき	音咲いつき	人名
おとはねえみ	乙羽映見	人名
かずきそら	和希そら	人名
かのまりあ	花乃まりあ	人名
かのはとき	叶羽時	人名
かれんえみり	華蓮エミリ	人名
きさきあいり	綺咲愛里	人名
ごじょうまりな	五條まりな	人名
さきひみゆ	咲妃みゆ	人名
さくらなあい	桜奈あい	人名
さらさなち	更紗那知	人名
しどうりゅう	紫藤りゅう	人名
しらとりゆりや	白鳥ゆりや	人名
せとはなまり	瀬戸花まり	人名
そうやともき	蒼矢朋季	人名
そらなみこう	空波輝	人名
たかしなりょう	貴姿りょう	人名
たくとれい	拓斗れい	人名
たちばなこう	橘幸	人名
ちゆきあき	千幸あき	人名
はやきゆうと	颯希有翔	人名
はるみゆう	春海ゆう	人名
ひめはなゆきの	妃華ゆきの	人名
まちゆうか	真地佑果	人名
みおうえりな	美桜エリナ	人名
むつきせら	夢月せら	人名
ゆうなみけい	優波慧	人名
ゆめかあみ	夢華あみ	人名
ゆめなるね	夢奈瑠音	人名
らんまゆう	蘭舞ゆう	人名
りさきしぐれ	里咲しぐれ	人名



あおせゆうき	蒼瀬侑季	人名
あおみやるか	碧宮るか	人名
あきなるい	秋奈るい	人名
あさぎりまこと	朝霧真	人名
あさひなあおい	朝日奈蒼	人名
あやきひかり	綺城ひか理	人名
いろはれお	彩葉玲央	人名
うみのみつき	海乃美月	人名
おうはみらい	凰羽みらい	人名
かしろあおい	佳城葵	人名
かとりれいら	華鳥礼良	人名
かのうゆうり	叶ゆうり	人名
くれはまき	紅羽真希	人名
さいづきつくし	彩月つくし	人名
さらあんな	沙羅アンナ	人名
さわかづき	澤佳津伎	人名
しろきみれい	城妃美伶	人名
たかとおすず	貴遠すず	人名
とうどうじゅん	桃堂純	人名
とわきせあ	永久輝せあ	人名
はなびしりず	花菱りず	人名
はるひうらら	春妃うらら	人名
ひなりりか	雛リリカ	人名
ひめさきみれい	姫咲美礼	人名
ひめのれえ	ひめ乃礼絵	人名
まいやせいか	舞矢聖華	人名
みずかいち	水香依千	人名
みずさるる	水沙瑠流	人名
みなづきまき	水月牧	人名
やぶきせな	矢吹世奈	人名
ゆめなつき	夢なつき	人名
ゆめとあさみ	夢人麻未	人名
るいまきせ	留依蒔世	人名
れんつかさ	蓮つかさ	人名



あかつきちせい	暁千星	人名
こはるのさよ	小春乃さよ	人名
あまはなえま	天華えま	人名
しんじょうまから	真條まから	人名
るかぜひかる	瑠風輝	人名
あやおうか	綾凰華	人名
みおのさき	澪乃桜季	人名
はるはらら	遥羽らら	人名
じゅんなすばる	潤奈すばる	人名
ひりゅうつかさ	飛龍つかさ	人名
まあやきほ	真彩希帆	人名
せいなのぞみ	星南のぞみ	人名
みとくらら	美都くらら	人名
ゆかりのこゆき	紫乃小雪	人名
あやなみけいと	彩波けいと	人名
ほまれせり	穂稀せり	人名
みなとるひ	湊瑠飛	人名
みねかとわ	峰果とわ	人名
ありさひとみ	有沙瞳	人名
うららせんり	麗泉里	人名
ゆめのかまい	夢乃花舞	人名
ななきかおる	七輝かおる	人名
ほうかはるな	鳳華はるな	人名
かざきしゅん	風輝駿	人名
あまきほまれ	天希ほまれ	人名
そうませれん	蒼真せれん	人名
はなゆきりら	華雪りら	人名
かなみせな	叶海世奈	人名
きよからん	清華蘭	人名
すおうまひろ	周旺真広	人名
しざきれの	紫咲樹れの	人名
ゆうなぎりょう	夕渚りょう	人名
せなみはや	瀬南海はや	人名
おとかぜせいや	音風せいや	人名
おうかりな	桜花りな	人名
みおかあんり	美丘安里	人名
まれいさやな	茉玲さや那	人名
ひづきゆめ	妃月ゆめ	人名
なおみりせ	尚央海りせ	人名
すみづきなおと	澄月菜音	人名



あさひつばさ	朝陽つばさ	人名
あまじそら	天路そら	人名
あませはつひ	天瀬はつひ	人名
あまのきよら	天乃きよら	人名
あれんとうま	亜蓮冬馬	人名
いろどりみちる	彩みちる	人名
おうりまお	桜里まお	人名
きおかなで	輝生かなで	人名
きほうかなた	希峰かなた	人名
こざくらほのか	小桜ほのか	人名
さくとみなき	咲翔みなき	人名
さくららからん	桜良花嵐	人名
すみかぜなぎ	澄風なぎ	人名
すわさき	諏訪さき	人名
そうぶさきほ	蒼舞咲歩	人名
たかみねじゅん	高峰潤	人名
つきはなゆきの	月華雪乃	人名
ななせみき	七星美妃	人名
ののかひまり	野々花ひまり	人名
はなきまいあ	華妃まいあ	人名
はなぶさかおと	英かおと	人名
はやとれお	隼玲央	人名
はるとゆうほ	遥斗勇帆	人名
はるやゆうり	春矢祐璃	人名
ひいなりん	ひいな凜	人名
ひうみありさ	陽海ありさ	人名
ひなたはるき	陽向春輝	人名
ひめかひなの	姫歌ひな乃	人名
ほずみまひろ	帆純まひろ	人名
まいひなかのん	舞雛かのん	人名
まなづきこう	万名月洸	人名
みそのさくら	美園さくら	人名
みずきめい	瑞希めい	人名
りおうじゅん	璃央じゅん	人名
りんのしづか	凛乃しづか	人名
わかくさもえか	若草萌香	人名
わかとりつ	若翔りつ	人名



らんなおき	蘭尚樹	人名
おとくりす	音くり寿	人名
ほしかぜまどか	星風まどか	人名
いとつきゆきは	糸月雪羽	人名
あまいろみねり	天彩峰里	人名
はおりゆうか	羽織夕夏	人名
ゆうきしおん	優希しおん	人名
まなみひかる	愛海ひかる	人名
かざまゆの	風間柚乃	人名
せいのあすか	聖乃あすか	人名
はるかこころ	はる香心	人名
ももかゆき	桃歌雪	人名
きさかおる	希沙薫	人名
きららうみ	希良々うみ	人名
さくらばまい	桜庭舞	人名
きらりあん	きらり杏	人名
あかしれいま	朱紫令真	人名
にじょうはな	二條華	人名
せいかりあん	星加梨杏	人名
はづきりらん	蓮月りらん	人名
まのみやるい	眞ノ宮るい	人名
きわみしん	極美慎	人名
はなゆうき	華優希	人名
いずみまいら	泉まいら	人名
いちのせこうき	一之瀬航季	人名
ゆきのかさり	雪乃かさり	人名
ひすみりん	妃純凛	人名
こなんまこと	琥南まこと	人名
なつかぜきき	夏風季々	人名
かなとみやび	奏音雅	人名
そらしろゆう	空城ゆう	人名
あらたときや	新斗希矢	人名
ゆめまおと	ゆめ真音	人名
しおせかざみ	汐聖風美	人名
まいはなみりあ	舞華みりあ	人名
かずれいさ	和礼彩	人名
まいきつばさ	舞希翼	人名
こうえりせ	煌えりせ	人名
あおつきれん	碧月れん	人名
