!!ATOK_TANGO_TEXT_HEADER_1
!! Wikipediaからコピペしてるので間違いあるかも

!! 専科
かすがのやちよ	春日野八千代	固有人名*	宝塚
まつもとゆり	松本悠里	固有人名*	宝塚
きょうみさ	京三紗	固有人名*	宝塚
いつきちひろ	一樹千尋	固有人名*	宝塚
こうあけみ	光あけみ	固有人名*	宝塚

!! 57期生

あいぞのゆか	藍園ゆか	固有人名*	宝塚
あきらみやび	晃みやび	固有人名*	宝塚
あこちなみ	亜湖千波	固有人名*	宝塚
あさみつる	麻みつる	固有人名*	宝塚
あしさおり	芦沙織	固有人名*	宝塚
いずようこ	伊豆踊子	固有人名*	宝塚
うしおはるか	潮はるか	固有人名*	宝塚
かつみひろし	克美仁	固有人名*	宝塚
かもづるみき	賀茂鶴みき	固有人名*	宝塚
かんなあい	神奈吾衣	固有人名*	宝塚
きたこうじみほ	北小路みほ	固有人名*	宝塚
きたはらちこと	北原千琴	固有人名*	宝塚
きぬがさあきら	衣笠彰	固有人名*	宝塚
きょうみさこ	京三紗子	固有人名*	宝塚
きりゅうのぼる	桐生のぼる	固有人名*	宝塚
くれたけひかる	呉竹晃	固有人名*	宝塚
くれないひとみ	紅ひとみ	固有人名*	宝塚
けいかがり	圭加々利	固有人名*	宝塚
こうちひろき	高地ひろき	固有人名*	宝塚
こはやかわゆき	小早川有希	固有人名*	宝塚
さかきなお	榊なお	固有人名*	宝塚
さらけい	沙羅けい	固有人名*	宝塚
さんじょうありさ	三条有左	固有人名*	宝塚
しんさやき	真さや希	固有人名*	宝塚
たかおかけいこ	高丘けい子	固有人名*	宝塚
たかしょうめぐみ	鷹匠恵	固有人名*	宝塚
たかつくみ	貴津句美	固有人名*	宝塚
たまよせひかる	玉寄ひかる	固有人名*	宝塚
たまるいこ	珠るい子	固有人名*	宝塚
ちさとひろみ	千里ひろみ	固有人名*	宝塚
ともちはる	友ちはる	固有人名*	宝塚
とりゅうみち	登流路	固有人名*	宝塚
なかいおり	央いおり	固有人名*	宝塚
なつきてる	夏季暉	固有人名*	宝塚
なとりれい	汝鳥玲	固有人名*	宝塚
にしきのはなよ	錦乃花世	固有人名*	宝塚
はづきしげる	葉月しげる	固有人名*	宝塚
はにりお	埴りお	固有人名*	宝塚
はやぶさあみり	隼あみり	固有人名*	宝塚
ほうじょうひろき	鳳城ひろき	固有人名*	宝塚
ほなみまこと	帆波真琴	固有人名*	宝塚
まぎりあや	真桐彩	固有人名*	宝塚
まなひろか	真南ひろか	固有人名*	宝塚
まりれいか	毬れいか	固有人名*	宝塚
みしえる	美詩える	固有人名*	宝塚
みたまちよ	美珠千代	固有人名*	宝塚
みほまりか	美甫まりか	固有人名*	宝塚
もんあみ	紋あみ	固有人名*	宝塚
ゆうしらべ	優しらべ	固有人名*	宝塚
ゆづきかおる	佑月薫	固有人名*	宝塚
ゆめまどか	夢まどか	固有人名*	宝塚
よしのまな	美野真奈	固有人名*	宝塚
るいあづち	塁あづち	固有人名*	宝塚
れみりょう	礼美良	固有人名*	宝塚
れんちお	漣千央	固有人名*	宝塚

!! 58期生

あかつきるみ	暁留美	固有人名*	宝塚
あかねまゆみ	茜真弓	固有人名*	宝塚
あらたみき	新みき	固有人名*	宝塚
あらんみか	亜蘭美香	固有人名*	宝塚
うみしらほ	海しらほ	固有人名*	宝塚
うめざとちえり	梅里ちえり	固有人名*	宝塚
えまちあき	江真千晶	固有人名*	宝塚
かぜかおる	風かおる	固有人名*	宝塚
かつらみき	桂美紀	固有人名*	宝塚
くになつき	邦なつき	固有人名*	宝塚
くみまり	久美まり	固有人名*	宝塚
ここまりも	湖々まりも	固有人名*	宝塚
ごしょまゆか	御所まゆか	固有人名*	宝塚
ごじょうあいせん	五條愛川	固有人名*	宝塚
ことぶきひづる	寿ひづる	固有人名*	宝塚
さおりみつよ	早織光世	固有人名*	宝塚
すみかわあけみ	純川暁美	固有人名*	宝塚
そのみはる	園みはる	固有人名*	宝塚
たかまりお	孝まりお	固有人名*	宝塚
たかしおともえ	高汐巴	固有人名*	宝塚
たかほりな	高帆里奈	固有人名*	宝塚
ちしろけい	千城恵	固有人名*	宝塚
ちなゆみの	千奈ゆみの	固有人名*	宝塚
ちひろさかえ	千尋栄	固有人名*	宝塚
ちぶねゆか	千船友歌	固有人名*	宝塚
なぎりよう	波切洋	固有人名*	宝塚
なるみゆき	成美有紀	固有人名*	宝塚
ののひかり	野々ひかり	固有人名*	宝塚
はとぶえまき	鳩笛真季	固有人名*	宝塚
はなぞのまり	花園まり	固有人名*	宝塚
はなみかおり	花美香	固有人名*	宝塚
ひかりかおこ	光香王子	固有人名*	宝塚
びゃくどうれいな	白道れい奈	固有人名*	宝塚
ふじなみゆう	藤波ゆう	固有人名*	宝塚
まきなえりか	牧奈えりか	固有人名*	宝塚
ましおちなみ	真汐ちなみ	固有人名*	宝塚
ましばしん	真柴真	固有人名*	宝塚
まつかぜさとみ	松風都巳	固有人名*	宝塚
まりひかる	麻里光	固有人名*	宝塚
みかどゆき	美門有輝	固有人名*	宝塚
みちのぼる	路のぼる	固有人名*	宝塚
みねさおり	峰さを理	固有人名*	宝塚
みのりあき	實亜紀	固有人名*	宝塚
やしろはるな	八代東奈	固有人名*	宝塚
ゆうづるまい	夕鶴まい	固有人名*	宝塚
ゆうびあい	優美あい	固有人名*	宝塚
ゆきれいな	有季れいな	固有人名*	宝塚
ゆたかあゆむ	裕あゆむ	固有人名*	宝塚

!! 59期生

あやこまき	綾こまき	固有人名*	宝塚
あんうらら	杏うらら	固有人名*	宝塚
いくかつみ	育かつみ	固有人名*	宝塚
いなばかよ	稲葉かよ	固有人名*	宝塚
うらまつほ	浦まつほ	固有人名*	宝塚
えいなかおる	英奈かほる	固有人名*	宝塚
おうわたる	欧わたる	固有人名*	宝塚
おおづきせりか	凰月せりか	固有人名*	宝塚
かざまいりや	風間イリヤ	固有人名*	宝塚
かじりゅうこ	楫竜子	固有人名*	宝塚
こいのぼる	鯉のぼる	固有人名*	宝塚
こじょうちあき	湖条千秋	固有人名*	宝塚
ことさおり	琴さおり	固有人名*	宝塚
さちかおる	沙智薫	固有人名*	宝塚
さわなもえ	沢奈もえ	固有人名*	宝塚
しきいずみ	紫城いずみ	固有人名*	宝塚
しきのはなえ	四季乃花恵	固有人名*	宝塚
しのじりさ	紫乃路りさ	固有人名*	宝塚
しまはるき	紫摩はるき	固有人名*	宝塚
しゃみよ	謝美世	固有人名*	宝塚
しわきょうこ	志和杏子	固有人名*	宝塚
しんもえる	真もえる	固有人名*	宝塚
じんなつみ	陣夏実	固有人名*	宝塚
すがたはるか	姿晴香	固有人名*	宝塚
せりまちか	芹まちか	固有人名*	宝塚
せんなつこ	泉奈都子	固有人名*	宝塚
だいちまお	大地真央	固有人名*	宝塚
たいらみち	平みち	固有人名*	宝塚
たきあずさ	多岐あずさ	固有人名*	宝塚
たまきあやめ	珠希あやめ	固有人名*	宝塚
だんなつき	団なつき	固有人名*	宝塚
ちはらゆうり	千原悠利	固有人名*	宝塚
なみじようこ	南美路遥子	固有人名*	宝塚
はなおまき	花尾まき	固有人名*	宝塚
ひだみどり	飛騨翠	固有人名*	宝塚
ひろきじゅん	広樹淳	固有人名*	宝塚
ほくとひかる	北斗ひかる	固有人名*	宝塚
まきさやか	槇さやか	固有人名*	宝塚
みかみみゆり	三神美百合	固有人名*	宝塚
みさのえる	未沙のえる	固有人名*	宝塚
みずさわゆき	水沢柚紀	固有人名*	宝塚
みちあんり	未知あんり	固有人名*	宝塚
みなゆきほ	水奈ゆきほ	固有人名*	宝塚
みなみまりよ	南万里代	固有人名*	宝塚
みわちぐさ	美和ちぐさ	固有人名*	宝塚
もえぎなつ	萠季夏	固有人名*	宝塚
やましろはるか	山城はるか	固有人名*	宝塚
ゆみましろ	由美ましろ	固有人名*	宝塚
らんさがの	嵐さがの	固有人名*	宝塚

!! 60期生

あおきりょう	青樹りょう	固有人名*	宝塚
あきかのう	亜希かのう	固有人名*	宝塚
あけちきほ	明知希帆	固有人名*	宝塚
あゆはらさなえ	鮎原さなえ	固有人名*	宝塚
いそのちひろ	磯野千尋	固有人名*	宝塚
おおうらみずき	大浦みずき	固有人名*	宝塚
おおたてはと	大立鳩	固有人名*	宝塚
きくかおる	貴久香	固有人名*	宝塚
こうじょうひろみ	光城ひろみ	固有人名*	宝塚
こしふじこ	越富士子	固有人名*	宝塚
しらゆきあい	白雪愛	固有人名*	宝塚
せんじゅけい	千寿慧	固有人名*	宝塚
そらたかこ	空タカ子	固有人名*	宝塚
たえくるみ	妙くるみ	固有人名*	宝塚
たけはらさゆり	竹原小百合	固有人名*	宝塚
たちばなまりこ	橘万里子	固有人名*	宝塚
ちあきまなか	千晶まなか	固有人名*	宝塚
つきおかちかげ	月丘千景	固有人名*	宝塚
つるぎみゆき	剣幸	固有人名*	宝塚
なつせあまね	夏瀬あまね	固有人名*	宝塚
ななあさみ	奈々あさみ	固有人名*	宝塚
なるかみじゅん	鳴上順	固有人名*	宝塚
のぞみゆうこ	希夕子	固有人名*	宝塚
のばらあけみ	野ばら朱実	固有人名*	宝塚
はやみりつ	早美律	固有人名*	宝塚
はるかくらら	遥くらら	固有人名*	宝塚
ひなみれいか	日南れい香	固有人名*	宝塚
ひめはくちょう	姫白鳥	固有人名*	宝塚
まちゆう	街ゆう	固有人名*	宝塚
まつかみちる	松香みちる	固有人名*	宝塚
まのゆりあ	真乃ゆりあ	固有人名*	宝塚
みおはじめ	未央一	固有人名*	宝塚
みかちえり	美花ちえり	固有人名*	宝塚
みやつかさ	宮つかさ	固有人名*	宝塚
めぐみはなえ	恵花恵	固有人名*	宝塚
やさとごう	八郷ごう	固有人名*	宝塚
やまざとしおり	山里栞	固有人名*	宝塚
らんこのみ	蘭このみ	固有人名*	宝塚
わかみやあいの	若宮あいの	固有人名*	宝塚
わこうあすか	若生あすか	固有人名*	宝塚

!! 61期生

あいだまち	愛田まち	固有人名*	宝塚
あごうさち	あごう沙知	固有人名*	宝塚
あさひかり	麻光	固有人名*	宝塚
あさかじゅん	朝香じゅん	固有人名*	宝塚
あさかぜめぐみ	朝風めぐみ	固有人名*	宝塚
あらたちひろ	新千宏	固有人名*	宝塚
あんじょうひじり	安城聖	固有人名*	宝塚
いすずさより	五十鈴さより	固有人名*	宝塚
いちはらけい	一原けい	固有人名*	宝塚
えびらかおる	箙かおる	固有人名*	宝塚
えりみゆき	江里美幸	固有人名*	宝塚
おうぎちか	扇千花	固有人名*	宝塚
おおかわれお	大川令於	固有人名*	宝塚
おおしろつばさ	大城つばさ	固有人名*	宝塚
かげちさと	影ちさと	固有人名*	宝塚
かざほりさ	風帆里紗	固有人名*	宝塚
きりさとみ	桐さと実	固有人名*	宝塚
こじょうれいか	湖条れいか	固有人名*	宝塚
さいじょうあんな	西城杏奈	固有人名*	宝塚
さおとめまりあ	早乙女マリア	固有人名*	宝塚
すじゃくかおる	朱雀薫	固有人名*	宝塚
すずみね	鈴美音	固有人名*	宝塚
せおはやみ	瀬尾はやみ	固有人名*	宝塚
せんみどり	千みどり	固有人名*	宝塚
たまきじゅん	環潤	固有人名*	宝塚
ちどりさくら	千鳥さくら	固有人名*	宝塚
ときのぼる	朱鷺のぼる	固有人名*	宝塚
なぎまさみ	奈樹まさみ	固有人名*	宝塚
なちまさる	奈知優	固有人名*	宝塚
なつかわゆかり	夏川ゆかり	固有人名*	宝塚
なつきじゅん	夏城淳	固有人名*	宝塚
はなじょうまりえ	花篠まり恵	固有人名*	宝塚
はなみやらら	花宮らら	固有人名*	宝塚
ひのとりみな	火の鳥美奈	固有人名*	宝塚
ほしづきみさ	星月美砂	固有人名*	宝塚
ほだかまり	穂高真理	固有人名*	宝塚
まいずみさり	麻泉沙里	固有人名*	宝塚
まやみつほ	摩耶みつほ	固有人名*	宝塚
まゆなつみ	麻由なつみ	固有人名*	宝塚
みずきせい	瑞城聖	固有人名*	宝塚
みふねさち	美舟幸	固有人名*	宝塚
みよかおり	美代かほり	固有人名*	宝塚
ゆうひかり	優ひかり	固有人名*	宝塚
りかまなみ	梨花まなみ	固有人名*	宝塚
れいさぎり	礼さぎり	固有人名*	宝塚
わかばひろみ	若葉ひろみ	固有人名*	宝塚

!! 62期生

あけほめみ	朱穂芽美	固有人名*	宝塚
あすかゆう	飛鳥裕	固有人名*	宝塚
あみじゅん	亜実じゅん	固有人名*	宝塚
あやはろみ	綾羽絽美	固有人名*	宝塚
ありさゆみか	有紗ゆ美か	固有人名*	宝塚
いぶきあい	伊吹あい	固有人名*	宝塚
えばらみこと	江原美琴	固有人名*	宝塚
えみちなつ	江美千夏	固有人名*	宝塚
おりづるらん	折鶴蘭	固有人名*	宝塚
かずさまき	和佐まき	固有人名*	宝塚
かちょういつき	花鳥いつき	固有人名*	宝塚
かもせんじょう	加茂千条	固有人名*	宝塚
きさらぎみれい	如月巳麗	固有人名*	宝塚
きりしません	霧島仟	固有人名*	宝塚
こうなおみ	幸直美	固有人名*	宝塚
ことづきちこ	琴月千湖	固有人名*	宝塚
さとみひろ	里美宏	固有人名*	宝塚
しおみつる	汐みつる	固有人名*	宝塚
せがわかえ	瀬川佳英	固有人名*	宝塚
たかせみあ	高瀬美亜	固有人名*	宝塚
たかみねはるか	高峰はるか	固有人名*	宝塚
たつきゆう	立木夕雨	固有人名*	宝塚
ちなみしょう	千波翔	固有人名*	宝塚
ちはやひろみ	千速紘実	固有人名*	宝塚
ちほさやか	千帆さやか	固有人名*	宝塚
つくしきょう	九十九恭	固有人名*	宝塚
つづれさみ	つづれ沙実	固有人名*	宝塚
ともちふゆ	知直冬	固有人名*	宝塚
なつますみ	夏ますみ	固有人名*	宝塚
なつみよう	夏美よう	固有人名*	宝塚
ななおとも	奈々央とも	固有人名*	宝塚
はなさきかおり	花咲かおり	固有人名*	宝塚
はるのみりか	春乃美里花	固有人名*	宝塚
ひゅうがかおる	日向薫	固有人名*	宝塚
ふじやよい	冨士やよひ	固有人名*	宝塚
ふぶきひとみ	吹雪仁美	固有人名*	宝塚
ほうじょうさゆり	宝城さゆり	固有人名*	宝塚
まさきこう	正規煌	固有人名*	宝塚
みかぜりざ	美風りざ	固有人名*	宝塚
みさきあゆみ	美咲あゆみ	固有人名*	宝塚
みずしまそのお	瑞志麻そのを	固有人名*	宝塚
みそのじゅり	美薗珠里	固有人名*	宝塚
みやびまり	雅まり	固有人名*	宝塚
みれいつくし	美嶺つくし	固有人名*	宝塚
ゆきしろまりか	雪城まりか	固有人名*	宝塚
りゅうらいか	竜らいか	固有人名*	宝塚
わかくさかおる	若草かおる	固有人名*	宝塚
わかなくみ	若菜くみ	固有人名*	宝塚

!! 63期生

あいなまゆき	愛奈まゆき	固有人名*	宝塚
あいはらさゆみ	愛原さゆ美	固有人名*	宝塚
あおいみや	葵美哉	固有人名*	宝塚
あかつきみさと	暁美里	固有人名*	宝塚
あさかわみさ	麻川美紗	固有人名*	宝塚
あさひなひかる	朝日奈光	固有人名*	宝塚
あしぶえるか	葦笛るか	固有人名*	宝塚
あずさのぼる	梓のぼる	固有人名*	宝塚
あそういずみ	麻生いず美	固有人名*	宝塚
あづみれいか	あづみれいか	固有人名*	宝塚
あやたつみ	彩辰美	固有人名*	宝塚
ありすみき	ありす未来	固有人名*	宝塚
いちじょうけん	一城けん	固有人名*	宝塚
いづきゆか	いづき結花	固有人名*	宝塚
おうなつき	旺なつき	固有人名*	宝塚
かのうるい	叶るい	固有人名*	宝塚
ことちはる	古都ちはる	固有人名*	宝塚
さえぐさみき	三枝みき	固有人名*	宝塚
さきえりさ	咲衣里紗	固有人名*	宝塚
さほまさよ	佐保雅世	固有人名*	宝塚
さやはつか	さや初夏	固有人名*	宝塚
しじょうななほ	詩条なな帆	固有人名*	宝塚
しほうゆき	紫峰ゆき	固有人名*	宝塚
たかしろまや	貴城麻也	固有人名*	宝塚
たかねしのぶ	高嶺忍	固有人名*	宝塚
つづみちな	鼓千奈	固有人名*	宝塚
ときわさちこ	常盤幸子	固有人名*	宝塚
なおきりえ	直城理恵	固有人名*	宝塚
なみゆりか	奈美ゆりか	固有人名*	宝塚
はつしろいずる	初城いづる	固有人名*	宝塚
はやぶされん	隼れん	固有人名*	宝塚
ひとみまり	瞳真理	固有人名*	宝塚
ひらぎのゆかり	柊乃ゆかり	固有人名*	宝塚
ふじはなゆきえ	藤花雪絵	固有人名*	宝塚
ふゆきこずえ	冬城梢	固有人名*	宝塚
まいくにか	麻衣くにか	固有人名*	宝塚
まいかぜなみ	舞風奈三	固有人名*	宝塚
まきりさ	真樹りさ	固有人名*	宝塚
まことあい	真琴愛	固有人名*	宝塚
まふえひびき	真笛ひびき	固有人名*	宝塚
みさわゆり	美佐和ゆり	固有人名*	宝塚
みねしろとわ	峰城とわ	固有人名*	宝塚
みゆきはなよ	美雪花代	固有人名*	宝塚
ゆうづきまほ	優月真帆	固有人名*	宝塚
よううらら	陽うらら	固有人名*	宝塚
りょうみお	涼美緒	固有人名*	宝塚

!! 64期生

あいかわまき	愛川麻貴	固有人名*	宝塚
あおやぎゆき	青柳有紀	固有人名*	宝塚
あかしのぼる	明石昇	固有人名*	宝塚
あきしのみほ	秋篠美帆	固有人名*	宝塚
あすなかりん	あすな花梨	固有人名*	宝塚
あんどうなち	杏東なち	固有人名*	宝塚
うららたまき	麗たまき	固有人名*	宝塚
かおるれな	薫怜奈	固有人名*	宝塚
かさいりか	加彩りか	固有人名*	宝塚
かしわぎけい	柏木けい	固有人名*	宝塚
かつらぎゆい	葛城ゆい	固有人名*	宝塚
かみしろしょうこ	上代粧子	固有人名*	宝塚
かもがわしぶき	加茂川志ぶき	固有人名*	宝塚
きたいずみ	北いずみ	固有人名*	宝塚
きぬなみき	絹なみ紀	固有人名*	宝塚
くさぶえまさこ	草笛雅子	固有人名*	宝塚
けいなつこ	渓夏子	固有人名*	宝塚
げんさやか	弦さやか	固有人名*	宝塚
ごうまゆか	郷真由加	固有人名*	宝塚
こちょうまいか	胡蝶舞花	固有人名*	宝塚
このみしま	このみ芝麻	固有人名*	宝塚
しおんゆう	紫苑ゆう	固有人名*	宝塚
せりなかぐさ	芹名香草	固有人名*	宝塚
たかはらるみか	高原るみ花	固有人名*	宝塚
たくみこう	匠鴻	固有人名*	宝塚
たけしろことえ	竹城琴絵	固有人名*	宝塚
たまみゆき	珠みゆき	固有人名*	宝塚
ちなつさゆり	千夏さゆり	固有人名*	宝塚
つばさひかる	翼ひかる	固有人名*	宝塚
つばさゆうき	翼悠貴	固有人名*	宝塚
なぎさりら	渚りら	固有人名*	宝塚
にしきもゆ	にしき望結	固有人名*	宝塚
にしなゆり	仁科有理	固有人名*	宝塚
はなかよの	花佳世乃	固有人名*	宝塚
はなだあい	花田あい	固有人名*	宝塚
ひいらぎかずき	柊和希	固有人名*	宝塚
ひびきみと	ひびき美都	固有人名*	宝塚
ふみさかえ	富美さかえ	固有人名*	宝塚
ほしむられお	星邑礼緒	固有人名*	宝塚
まいなゆみ	舞奈ゆみ	固有人名*	宝塚
みおりゆみの	御織ゆみ乃	固有人名*	宝塚
やよじるか	八世路るか	固有人名*	宝塚
ゆうなぎしほ	夕なぎ志帆	固有人名*	宝塚
ゆめぞのあやめ	夢苑あやめ	固有人名*	宝塚
れいかりゅう	麗香龍	固有人名*	宝塚
わかさつき	和花さつ希	固有人名*	宝塚

!! 65期生

あおもゆる	青もゆる	固有人名*	宝塚
あきつゆたか	明都ゆたか	固有人名*	宝塚
あけどりてるひ	朱鳥てるひ	固有人名*	宝塚
あさおかまい	麻岡真衣	固有人名*	宝塚
あしかわまき	葦川牧	固有人名*	宝塚
あやかげじゅん	彩景じゅん	固有人名*	宝塚
あやのにしき	綾乃にしき	固有人名*	宝塚
いけなみゆかり	池波ゆかり	固有人名*	宝塚
いちもんじしん	一文字新	固有人名*	宝塚
かがりあきら	篝輝	固有人名*	宝塚
きしろなつき	希城なつ紀	固有人名*	宝塚
きよまさみ	清まさみ	固有人名*	宝塚
こだいみずき	古代みず希	固有人名*	宝塚
さえづきみわ	冴月美和	固有人名*	宝塚
さつきりせ	五月梨世	固有人名*	宝塚
さよあかり	沙世あかり	固有人名*	宝塚
じゅんなめぐ	純奈めぐ	固有人名*	宝塚
しらかわあき	白川亜樹	固有人名*	宝塚
しらべゆう	調ゆう	固有人名*	宝塚
すずしろまりや	鈴代まりや	固有人名*	宝塚
そらちぐさ	空千草	固有人名*	宝塚
たちはらかえ	立原かえ	固有人名*	宝塚
たまうらあこ	珠浦阿湖	固有人名*	宝塚
たまなめい	たまなめい	固有人名*	宝塚
ちさまゆか	千沙まゆ香	固有人名*	宝塚
とわだますみ	十和田真澄	固有人名*	宝塚
なつのようこ	夏野陽子	固有人名*	宝塚
のぞえさゆき	野添さゆ紀	固有人名*	宝塚
ののみやあき	野々宮あき	固有人名*	宝塚
はなおかれみ	華丘玲巳	固有人名*	宝塚
はやせわたる	早瀬わたる	固有人名*	宝塚
はるかぜひとみ	春風ひとみ	固有人名*	宝塚
はるのあいり	春野亜衣梨	固有人名*	宝塚
はるのありさ	春野亜里紗	固有人名*	宝塚
ひしょうひかる	飛翔ひかる	固有人名*	宝塚
ひのきせいら	檜せいら	固有人名*	宝塚
まちだなな	街田奈々	固有人名*	宝塚
まりむらなお	鞠村奈緒	固有人名*	宝塚
みつきゆう	光木裕	固有人名*	宝塚
みなかぜまい	南風まい	固有人名*	宝塚
もりけあき	杜けあき	固有人名*	宝塚
ゆうきまゆ	結城繭	固有人名*	宝塚
ゆきあずさ	由樹あずさ	固有人名*	宝塚
ゆりかおる	由梨かおる	固有人名*	宝塚
わたりはや	渡はや	固有人名*	宝塚

!! 66期生

あさぶきなお	朝吹奈央	固有人名*	宝塚
あやかゆい	彩花ゆい	固有人名*	宝塚
ありみねりき	有峰里妃	固有人名*	宝塚
あんじゅみら	安寿ミラ	固有人名*	宝塚
いおりなつや	伊織なつ耶	固有人名*	宝塚
えりなじゅん	絵里奈じゅん	固有人名*	宝塚
おおさとみか	大里三佳	固有人名*	宝塚
おおぞらのぞみ	大空希望	固有人名*	宝塚
おおつあすか	大都あすか	固有人名*	宝塚
かあいもと	花愛望都	固有人名*	宝塚
かいさはる	櫂早春	固有人名*	宝塚
かすがまち	春日万知	固有人名*	宝塚
かやまちい	華山知位	固有人名*	宝塚
くにしろまや	邦城麻矢	固有人名*	宝塚
くるみじゅん	久留実純	固有人名*	宝塚
こうきらら	煌きらら	固有人名*	宝塚
こえいかなこ	湖映佳奈子	固有人名*	宝塚
こずえまなみ	梢真奈美	固有人名*	宝塚
こだまあい	こだま愛	固有人名*	宝塚
さちしのぶ	左知しのぶ	固有人名*	宝塚
さやかまちこ	沙耶花まち子	固有人名*	宝塚
さわちはる	沢千春	固有人名*	宝塚
さんじょうれい	三城礼	固有人名*	宝塚
しまゆうか	洲悠花	固有人名*	宝塚
せんじゅひかる	千珠晄	固有人名*	宝塚
だいごゆき	醍醐柚希	固有人名*	宝塚
たにみつる	谷みつる	固有人名*	宝塚
ちぐさまみ	千種まみ	固有人名*	宝塚
ちさきあいか	千咲あい花	固有人名*	宝塚
なしろえりか	奈代えりか	固有人名*	宝塚
なづきかなで	名月かなで	固有人名*	宝塚
なつおちか	夏生ちか	固有人名*	宝塚
ななせゆみ	七瀬ゆみ	固有人名*	宝塚
はなぶさまき	英マキ	固有人名*	宝塚
はなやけいこ	花彌恵子	固有人名*	宝塚
ひなつむぎ	日夏麦	固有人名*	宝塚
ふくじゅゆき	福寿ゆき	固有人名*	宝塚
ふゆづきしおか	冬月汐佳	固有人名*	宝塚
ほうじょうつぐみ	北條つぐみ	固有人名*	宝塚
まつみやふゆ	松宮芙夕	固有人名*	宝塚
まりやともこ	毬谷友子	固有人名*	宝塚
みかげしおり	美影しおり	固有人名*	宝塚
みさきこう	岬甲	固有人名*	宝塚
みねおかなち	峰丘奈知	固有人名*	宝塚
みやこのさくら	都乃さくら	固有人名*	宝塚
ももりえこ	桃梨江子	固有人名*	宝塚
やまとなつき	大和なつ希	固有人名*	宝塚
ゆうきこころ	友樹こころ	固有人名*	宝塚
りぐありさ	有具アリサ	固有人名*	宝塚
わかふじりら	若藤りら	固有人名*	宝塚

!! 67期生

あいゆりや	愛ゆりや	固有人名*	宝塚
あいこうみつる	愛甲充	固有人名*	宝塚
あきひさと	安輝ひさと	固有人名*	宝塚
あぎかつら	阿樹かつら	固有人名*	宝塚
あさぐもこがね	朝雲こがね	固有人名*	宝塚
いずみつかさ	泉つかさ	固有人名*	宝塚
うたしきあやか	歌敷綾花	固有人名*	宝塚
えのきりか	榎利佳	固有人名*	宝塚
おおさきみか	大咲実果	固有人名*	宝塚
かざはやみほ	風早三穂	固有人名*	宝塚
かじいっせい	舵一星	固有人名*	宝塚
かみさつき	賀美さつき	固有人名*	宝塚
きたはらようこ	北原遙子	固有人名*	宝塚
きよかしのぶ	潔香しのぶ	固有人名*	宝塚
くろきひとみ	黒木瞳	固有人名*	宝塚
さおとめさち	小乙女幸	固有人名*	宝塚
さぎりじゅん	沙霧じゅん	固有人名*	宝塚
さちかぜいれね	幸風イレネ	固有人名*	宝塚
すずかぜまよ	涼風真世	固有人名*	宝塚
なつきとも	夏樹智	固有人名*	宝塚
なつくさかおり	夏草かをり	固有人名*	宝塚
なみきかおり	並樹かおり	固有人名*	宝塚
なんごうきえ	南郷希恵	固有人名*	宝塚
はぎなおみ	萩奈緒美	固有人名*	宝塚
はなあかり	花朱里	固有人名*	宝塚
ふづきれい	文月玲	固有人名*	宝塚
まいきあや	舞希彩	固有人名*	宝塚
ますみゆたか	増美ゆた賀	固有人名*	宝塚
まちまりい	街麻利衣	固有人名*	宝塚
まやみき	真矢みき	固有人名*	宝塚
まりいつか	麻梨いつか	固有人名*	宝塚
まりもえり	毬藻えり	固有人名*	宝塚
みずはらたまき	水原環	固有人名*	宝塚
みつやなお	三ツ矢直生	固有人名*	宝塚
みどりなかようこ	緑中陽子	固有人名*	宝塚
みやまりな	宮麻里奈	固有人名*	宝塚
ゆうしおまなか	佑汐まな花	固有人名*	宝塚
ようあきら	燁明	固有人名*	宝塚
りかますみ	梨花ますみ	固有人名*	宝塚

!! 68期生

あかねよしみ	茜佳実	固有人名*	宝塚
あさなぎりん	朝凪鈴	固有人名*	宝塚
あやせるり	綾瀬るり	固有人名*	宝塚
いちろまき	一路万輝	固有人名*	宝塚
えまなおき	英真なおき	固有人名*	宝塚
おおきひろと	大樹ひろと	固有人名*	宝塚
おおみねまゆ	大峯麻友	固有人名*	宝塚
かがみちとせ	鏡ちとせ	固有人名*	宝塚
かずきまほ	一希真帆	固有人名*	宝塚
きたみまり	北見毬	固有人名*	宝塚
きなみちえ	希波千愛	固有人名*	宝塚
けいかずか	慶一花	固有人名*	宝塚
ごしきあらた	五色新	固有人名*	宝塚
さいきたくみ	才樹巧	固有人名*	宝塚
さくらりこ	桜里湖	固有人名*	宝塚
さくらぎせいこ	桜木星子	固有人名*	宝塚
さはらみゆき	早原みゆ紀	固有人名*	宝塚
さゆきれい	紗幸れい	固有人名*	宝塚
せいのぼる	勢のぼる	固有人名*	宝塚
せんだまゆみ	千田真弓	固有人名*	宝塚
そのおしずく	園生しずく	固有人名*	宝塚
ちことくるみ	千琴くるみ	固有人名*	宝塚
ちひろあい	千紘あい	固有人名*	宝塚
てんどうなぎさ	天道なぎさ	固有人名*	宝塚
なみねみちる	波音みちる	固有人名*	宝塚
はるうらら	春うらら	固有人名*	宝塚
ほしのむつみ	星乃睦実	固有人名*	宝塚
まきさおり	牧沙織	固有人名*	宝塚
ましばしゅん	真芝瞬	固有人名*	宝塚
まちかぜかな	町風佳奈	固有人名*	宝塚
まつばらみどり	松原碧	固有人名*	宝塚
みなみかいり	南海里	固有人名*	宝塚
みねおなな	峰央奈奈	固有人名*	宝塚
みはまじゅり	美浜寿里	固有人名*	宝塚
やしおゆうき	八汐佑希	固有人名*	宝塚
ゆきかぜれい	雪風嶺	固有人名*	宝塚
よどみやこ	淀都	固有人名*	宝塚

!! 69期生

あいかぜひかる	愛風ひかる	固有人名*	宝塚
あけぼのまや	曙真八	固有人名*	宝塚
あさおかなり	麻丘奈里	固有人名*	宝塚
あさぎみずほ	麻木瑞穂	固有人名*	宝塚
あさじさき	麻路さき	固有人名*	宝塚
あさつゆあかり	朝露あかり	固有人名*	宝塚
あずまみち	東三智	固有人名*	宝塚
あそうゆみ	麻生由美	固有人名*	宝塚
あまちひかり	天地ひかり	固有人名*	宝塚
いずもあや	出雲綾	固有人名*	宝塚
いちじょうあかね	一城茜	固有人名*	宝塚
うづきけい	卯月佳	固有人名*	宝塚
かいきょうひろき	海峡ひろき	固有人名*	宝塚
かきょうあすか	花鏡あすか	固有人名*	宝塚
かなちこと	香奈ちこと	固有人名*	宝塚
かりんいずみ	果林いずみ	固有人名*	宝塚
かんなみほ	神奈美帆	固有人名*	宝塚
くぜせいか	久世星佳	固有人名*	宝塚
くろかわみゆき	黒川深雪	固有人名*	宝塚
ごだいかつら	醐代かつら	固有人名*	宝塚
さわきまり	沢木満里	固有人名*	宝塚
しほうさぎり	紫峯さぎり	固有人名*	宝塚
しらさぎまどか	白鷺まどか	固有人名*	宝塚
しらはらかあい	白原可愛	固有人名*	宝塚
たかつきしょう	鷹月笙	固有人名*	宝塚
たかねふぶき	高嶺ふぶき	固有人名*	宝塚
たきはるか	滝はるか	固有人名*	宝塚
だんひとみ	檀ひとみ	固有人名*	宝塚
ちあきしん	千秋慎	固有人名*	宝塚
つくしのあや	筑紫野あや	固有人名*	宝塚
はなぶさりお	英りお	固有人名*	宝塚
ひじりますみ	聖真澄	固有人名*	宝塚
ひとみまりあ	瞳まりあ	固有人名*	宝塚
ひめまりか	姫まりか	固有人名*	宝塚
まゆずみれいな	黛れいな	固有人名*	宝塚
まゆみしずか	真弓しずか	固有人名*	宝塚
みきさやか	美樹さやか	固有人名*	宝塚
みずきじゅん	瑞木淳	固有人名*	宝塚
みつきあゆ	美月亜優	固有人名*	宝塚
みどりあきえ	翠章江	固有人名*	宝塚
みわさいこ	美輪さいこ	固有人名*	宝塚
ゆうまなつき	友麻夏希	固有人名*	宝塚
わかおりさ	若央りさ	固有人名*	宝塚
わかなあん	若菜あん	固有人名*	宝塚

!! 70期生

あおぞらはるか	青空はるか	固有人名*	宝塚
あおみれん	碧海蓮	固有人名*	宝塚
あかりなみ	灯奈美	固有人名*	宝塚
あきづきしほ	秋月志保	固有人名*	宝塚
いつきぎんか	いつき吟夏	固有人名*	宝塚
おとはらあい	乙原愛	固有人名*	宝塚
かざみれお	風見玲央	固有人名*	宝塚
かつらあさひ	桂あさひ	固有人名*	宝塚
きょうまいこ	今日舞子	固有人名*	宝塚
くさのめもゆ	草の芽もゆ	固有人名*	宝塚
くりはられいこ	栗原麗子	固有人名*	宝塚
ここのえはるか	九重はるか	固有人名*	宝塚
さわたりみき	沢渡三起	固有人名*	宝塚
しおねまこと	汐音真実	固有人名*	宝塚
しのゆか	詩乃優花	固有人名*	宝塚
せいさきほ	星沙紀帆	固有人名*	宝塚
だいきゆう	大輝ゆう	固有人名*	宝塚
たかじょうかのう	高城叶	固有人名*	宝塚
たかなしじゅん	高梨順	固有人名*	宝塚
たからぎめり	宝樹芽里	固有人名*	宝塚
なつおかおり	夏生かおり	固有人名*	宝塚
なつきまみ	夏妃真美	固有人名*	宝塚
なつみはるか	夏海はるか	固有人名*	宝塚
なつみねせん	夏峰千	固有人名*	宝塚
なつめかな	夏目佳奈	固有人名*	宝塚
にじぞのはるみ	虹園春美	固有人名*	宝塚
はごろもらん	羽衣蘭	固有人名*	宝塚
はなかげみき	花景美妃	固有人名*	宝塚
はねちさと	羽根知里	固有人名*	宝塚
ひいろゆかり	日色由佳理	固有人名*	宝塚
ましろともな	真代朋奈	固有人名*	宝塚
まつかぜりょう	松風良	固有人名*	宝塚
まりゆずみ	万里柚美	固有人名*	宝塚
むらさきとも	紫とも	固有人名*	宝塚
やよいみつき	弥生みつき	固有人名*	宝塚
ゆうみさお	悠みさ緒	固有人名*	宝塚
ゆきはらちなえ	雪原千苗	固有人名*	宝塚
ゆきむらきょうこ	雪邑響子	固有人名*	宝塚
らんれいか	蘭玲花	固有人名*	宝塚
わかきもえ	若木萌	固有人名*	宝塚
わかくさようこ	若草葉子	固有人名*	宝塚
わこうはじめ	和光一	固有人名*	宝塚

!! 71期生

あいかみれ	愛華みれ	固有人名*	宝塚
あかつきなぎさ	暁なぎさ	固有人名*	宝塚
あさぎりまい	朝霧舞	固有人名*	宝塚
あゆゆうき	鮎ゆうき	固有人名*	宝塚
いらかまや	いらか万椰	固有人名*	宝塚
えなかおる	絵奈かおる	固有人名*	宝塚
えみわかば	恵美若葉	固有人名*	宝塚
おおしおますみ	大潮ますみ	固有人名*	宝塚
おぎしろあやの	荻代彩乃	固有人名*	宝塚
こうきすばる	光樹すばる	固有人名*	宝塚
こうさかちあき	香坂千晶	固有人名*	宝塚
こじかまい	こじか真衣	固有人名*	宝塚
さえぐさみづき	三枝みづき	固有人名*	宝塚
さぎくさかおる	鷺草かおる	固有人名*	宝塚
さわひとみ	沢ひとみ	固有人名*	宝塚
しおじさよ	潮路小夜	固有人名*	宝塚
しおりみき	詩織みき	固有人名*	宝塚
しのはらゆい	篠原ゆい	固有人名*	宝塚
すみれのあいか	菫乃あいか	固有人名*	宝塚
せいかさくらこ	聖花桜子	固有人名*	宝塚
たかやぎみどり	貴柳みどり	固有人名*	宝塚
たさいしゅん	多彩しゅん	固有人名*	宝塚
たちばなさえ	橘沙恵	固有人名*	宝塚
たまきなお	珠木奈緒	固有人名*	宝塚
ちやあきら	地矢晃	固有人名*	宝塚
ちょうまいか	蝶まいか	固有人名*	宝塚
とどろきゆう	轟悠	固有人名*	宝塚
ともまいか	朋舞花	固有人名*	宝塚
とわあゆみ	登羽歩	固有人名*	宝塚
なつかわゆら	夏河ゆら	固有人名*	宝塚
なみじはるか	浪路はるか	固有人名*	宝塚
なんきちひろ	南紀ちひろ	固有人名*	宝塚
のうぶみつこ	能舞三子	固有人名*	宝塚
はぎおひとみ	萩尾仁美	固有人名*	宝塚
はくばれい	白馬麗	固有人名*	宝塚
はなようこ	華陽子	固有人名*	宝塚
ひょうゆうか	馮裕華	固有人名*	宝塚
ほたかつゆき	穂高つゆき	固有人名*	宝塚
まことつばさ	真琴つばさ	固有人名*	宝塚
まなかひかる	真中ひかる	固有人名*	宝塚
まりおみつき	毬央みつき	固有人名*	宝塚
みかさなみ	美夏小波	固有人名*	宝塚
みのるこう	稔幸	固有人名*	宝塚
みゆきあかね	美雪茜	固有人名*	宝塚
ゆうづきみか	夕月美佳	固有人名*	宝塚
ゆめのちこと	夢乃千琴	固有人名*	宝塚

!! 72期生

あいきしょう	愛輝翔	固有人名*	宝塚
あかねこのみ	茜このみ	固有人名*	宝塚
あきのさとみ	秋野里実	固有人名*	宝塚
あさかげるい	朝景るい	固有人名*	宝塚
あさかぜゆき	朝風ゆき	固有人名*	宝塚
あさなあゆみ	朝奈亜弓	固有人名*	宝塚
いつみねあき	五峰亜季	固有人名*	宝塚
おうぎちひろ	扇千尋	固有人名*	宝塚
おうじょうみき	王城美希	固有人名*	宝塚
おおはらゆうか	大原ゆうか	固有人名*	宝塚
おおまいかおり	大舞夏織	固有人名*	宝塚
おおみひろ	大海ひろ	固有人名*	宝塚
きりはらしょうこ	霧原翔子	固有人名*	宝塚
くれないかすみ	紅霞	固有人名*	宝塚
こうじゅたつき	香寿たつき	固有人名*	宝塚
こしはるき	越はるき	固有人名*	宝塚
さかきじゅん	榊純	固有人名*	宝塚
さざなみあい	漣あい	固有人名*	宝塚
しじょうひかる	紫城輝	固有人名*	宝塚
しぶきじゅん	紫吹淳	固有人名*	宝塚
しょうつかさ	翔つかさ	固有人名*	宝塚
しょうのさき	彰乃早紀	固有人名*	宝塚
そうだやすこ	宗田靖子	固有人名*	宝塚
だいしょうかおる	大翔薫	固有人名*	宝塚
たかちほまい	高千穂舞	固有人名*	宝塚
たままどか	珠まどか	固有人名*	宝塚
とおのなおみ	遠野なほみ	固有人名*	宝塚
なかじょうまり	中条まり	固有人名*	宝塚
なつまりこ	夏毬子	固有人名*	宝塚
にしきあい	にしき愛	固有人名*	宝塚
はやみけい	速水渓	固有人名*	宝塚
ひのきかおる	檜薫	固有人名*	宝塚
まおりゆき	真織由季	固有人名*	宝塚
まやまはる	真山葉瑠	固有人名*	宝塚
まりおかともみ	毬丘智美	固有人名*	宝塚
まりなとも	毬菜友	固有人名*	宝塚
みおれいな	澪れいな	固有人名*	宝塚
みぐさゆう	美草由布	固有人名*	宝塚
みしろまり	美城まり	固有人名*	宝塚
みはらしほ	美原志帆	固有人名*	宝塚
みやびけい	雅景	固有人名*	宝塚
もえみせりか	萌水せりか	固有人名*	宝塚
やぶきしょう	矢吹翔	固有人名*	宝塚
ゆうびかがり	優美かがり	固有人名*	宝塚
れいみか	麗美花	固有人名*	宝塚

!! 73期生

あおやまゆきな	青山雪菜	固有人名*	宝塚
あさおりつき	麻央りつき	固有人名*	宝塚
あさぶきみなみ	朝吹南	固有人名*	宝塚
あまじゆか	天路ゆか	固有人名*	宝塚
あまみゆうき	天海祐希	固有人名*	宝塚
あやかゆう	彩夏ゆう	固有人名*	宝塚
いちえりか	一絵梨花	固有人名*	宝塚
うじょうかおる	卯城薫	固有人名*	宝塚
えまおゆう	絵麻緒ゆう	固有人名*	宝塚
おおともれいか	大伴れいか	固有人名*	宝塚
おづきさゆる	小月さゆる	固有人名*	宝塚
かいちひろ	甲斐千ひろ	固有人名*	宝塚
かずひろき	和宏樹	固有人名*	宝塚
かつらぎななほ	葛城七穂	固有人名*	宝塚
かのうちほ	叶千穂	固有人名*	宝塚
かほひかる	花帆ひかる	固有人名*	宝塚
きたやまりな	北山里奈	固有人名*	宝塚
ごじょうまい	五条まい	固有人名*	宝塚
こなみあづさ	木南あづさ	固有人名*	宝塚
しづきあさと	姿月あさと	固有人名*	宝塚
しゅみちる	朱未知留	固有人名*	宝塚
しらほまり	白帆まり	固有人名*	宝塚
そのななみ	苑ななみ	固有人名*	宝塚
たいがれん	大河れん	固有人名*	宝塚
たかゆうき	鷹悠貴	固有人名*	宝塚
たくみひびき	匠ひびき	固有人名*	宝塚
ちとせまなぶ	千歳まなぶ	固有人名*	宝塚
なつしろれい	夏城令	固有人名*	宝塚
にじょうゆずる	二条ゆずる	固有人名*	宝塚
のぞみけい	希佳	固有人名*	宝塚
はましおか	浜汐花	固有人名*	宝塚
はまかぜあい	浜風愛	固有人名*	宝塚
ひろきさち	広希さち	固有人名*	宝塚
まつなみみつる	松波美鶴	固有人名*	宝塚
まりかなみ	毬花なみ	固有人名*	宝塚
みすずりりか	美鈴りり花	固有人名*	宝塚
みちあかり	路あかり	固有人名*	宝塚
みなときらら	湊きらら	固有人名*	宝塚
もりおかずみ	森央かずみ	固有人名*	宝塚
もろとりあい	諸鳥あい	固有人名*	宝塚
ゆうみれお	有未れお	固有人名*	宝塚
ゆきのまりえ	雪乃まり絵	固有人名*	宝塚

!!74期生

あきじしのぶ	秋路しのぶ	固有人名*	宝塚
あさきゆい	麻希ゆい	固有人名*	宝塚
あさのかよ	麻乃佳世	固有人名*	宝塚
あすかいまり	飛鳥井まり	固有人名*	宝塚
あんじょうありさ	安城ありさ	固有人名*	宝塚
うたぶえたつき	詩笛立季	固有人名*	宝塚
おおぞらみか	大空みか	固有人名*	宝塚
かずさまひろ	一紗まひろ	固有人名*	宝塚
かもうらら	加茂うらら	固有人名*	宝塚
かんだとも	神田智	固有人名*	宝塚
きづきあゆむ	貴月あゆむ	固有人名*	宝塚
きょうごくあやの	京極彩之	固有人名*	宝塚
こうづきまり	香月麻里	固有人名*	宝塚
こじょうらん	湖城蘭	固有人名*	宝塚
さがのゆり	嵯峨野ゆり	固有人名*	宝塚
さつきふたば	五月ふたば	固有人名*	宝塚
しおかぜこう	汐風幸	固有人名*	宝塚
しのぶむらさき	しのぶ紫	固有人名*	宝塚
しほうあけの	紫鳳あけの	固有人名*	宝塚
しらきあやか	白城あやか	固有人名*	宝塚
すずさとゆうか	涼里有花	固有人名*	宝塚
すずねりら	鈴音りら	固有人名*	宝塚
たちきみえ	立木みえ	固有人名*	宝塚
ときゆうか	時由布花	固有人名*	宝塚
なぎさあき	渚あき	固有人名*	宝塚
ななみひかる	七海光	固有人名*	宝塚
はつかぜみどり	初風緑	固有人名*	宝塚
はなおかみゆき	花丘美幸	固有人名*	宝塚
はなぞのゆかり	花園ゆかり	固有人名*	宝塚
はやせしょうま	はやせ翔馬	固有人名*	宝塚
ひみやれいこ	妃宮玲子	固有人名*	宝塚
ふたばかれん	二葉かれん	固有人名*	宝塚
ほづきみお	帆月みを	固有人名*	宝塚
まいじはるか	舞路はるか	固有人名*	宝塚
まちありさ	真地ありさ	固有人名*	宝塚
まつだいらるび	松平瑠美	固有人名*	宝塚
みさとまや	美郷真也	固有人名*	宝塚
みずしろなつみ	水城なつみ	固有人名*	宝塚
みみあんり	美々杏里	固有人名*	宝塚
もりなみはる	森奈みはる	固有人名*	宝塚
わおようか	和央ようか	固有人名*	宝塚

!! 75期生

あいはらせりか	逢原せりか	固有人名*	宝塚
あきよしあかね	秋吉あかね	固有人名*	宝塚
あやひろみ	彩ひろみ	固有人名*	宝塚
あやとれな	彩斗れな	固有人名*	宝塚
いおりなおか	伊織直加	固有人名*	宝塚
いぶきかず	伊吹和	固有人名*	宝塚
おおなつしづき	大夏しづき	固有人名*	宝塚
かおりゆたか	香織ゆたか	固有人名*	宝塚
かさいひとみ	花彩ひとみ	固有人名*	宝塚
かずきせい	一季星	固有人名*	宝塚
かみやゆき	神矢夕紀	固有人名*	宝塚
きしろみき	貴代光紀	固有人名*	宝塚
きりしまるか	桐島るか	固有人名*	宝塚
くさなぎゆき	草凪佑季	固有人名*	宝塚
くじょうあきら	久城彬	固有人名*	宝塚
こづきわたる	湖月わたる	固有人名*	宝塚
しきかおる	四季香	固有人名*	宝塚
じゅんあつき	純あつき	固有人名*	宝塚
たかくらきょう	高倉京	固有人名*	宝塚
たからぎあや	宝樹彩	固有人名*	宝塚
ちしろみき	千城美希	固有人名*	宝塚
なかはらくれあ	中原くれあ	固有人名*	宝塚
なつのさき	那津乃咲	固有人名*	宝塚
はなえまち	花会真地	固有人名*	宝塚
ふじしろまき	藤代真希	固有人名*	宝塚
まいおつばさ	舞央つばさ	固有人名*	宝塚
まそのありす	真園ありす	固有人名*	宝塚
まりさひとみ	万理沙ひとみ	固有人名*	宝塚
みさきすずな	美咲すずな	固有人名*	宝塚
みずきあい	みずき愛	固有人名*	宝塚
みずほたまき	瑞穂環	固有人名*	宝塚
みそのえりか	美苑えりか	固有人名*	宝塚
みなづきしずか	水月静	固有人名*	宝塚
みばえゆうり	実生友里	固有人名*	宝塚
みほけいこ	美穂圭子	固有人名*	宝塚
やまぶきさよ	山吹紗世	固有人名*	宝塚
ゆうきかおる	祐輝薫	固有人名*	宝塚
よしづきえり	嘉月絵理	固有人名*	宝塚
わかえゆき	若江由季	固有人名*	宝塚

!! 76期生

あいみやび	亜衣雅	固有人名*	宝塚
あさくらあおい	朝倉葵	固有人名*	宝塚
あさみねひかり	朝峰ひかり	固有人名*	宝塚
あまきかおり	天希かおり	固有人名*	宝塚
あやきなお	彩輝直	固有人名*	宝塚
えざきりせ	絵咲利瀬	固有人名*	宝塚
おうなみつばさ	欧波翼	固有人名*	宝塚
おおがあゆみ	大雅歩	固有人名*	宝塚
おおひろあゆむ	大洋あゆ夢	固有人名*	宝塚
おかかずみ	丘和巳	固有人名*	宝塚
おときみか	音木美香	固有人名*	宝塚
かえでさき	楓沙樹	固有人名*	宝塚
かざとゆま	風人夕真	固有人名*	宝塚
かざはなまい	風花舞	固有人名*	宝塚
かざはやゆう	風早優	固有人名*	宝塚
こちょうあすか	胡蝶明日香	固有人名*	宝塚
ことぶきつかさ	寿つかさ	固有人名*	宝塚
さがみれい	沙加美怜	固有人名*	宝塚
さちみあんな	幸美杏奈	固有人名*	宝塚
じゅりさきほ	樹里咲穂	固有人名*	宝塚
じゅんなりさ	純名里沙	固有人名*	宝塚
すずなさや	鈴奈沙也	固有人名*	宝塚
すずなみお	鈴奈美央	固有人名*	宝塚
たかしょうみずき	高翔みず希	固有人名*	宝塚
たかむれあゆ	高牟礼あゆ	固有人名*	宝塚
ちなみゆう	千波ゆう	固有人名*	宝塚
つきかげひとみ	月影瞳	固有人名*	宝塚
なしろあおい	名城あおい	固有人名*	宝塚
はづきれい	葉月れい	固有人名*	宝塚
ほしなゆり	星奈優里	固有人名*	宝塚
ほしのひとみ	星野瞳	固有人名*	宝塚
ましおいづる	真汐いづる	固有人名*	宝塚
まなみしほ	万波紫帆	固有人名*	宝塚
まゆかれお	真由華れお	固有人名*	宝塚
まよさくら	麻世さくら	固有人名*	宝塚
まりあいひとみ	毬愛ひとみ	固有人名*	宝塚
みどりはなか	翠花果	固有人名*	宝塚
ゆうやなほ	悠矢奈穂	固有人名*	宝塚
りょうあきの	陵あきの	固有人名*	宝塚
るなまり	瑠菜まり	固有人名*	宝塚

!! 77期生

あきみずほ	安岐みずほ	固有人名*	宝塚
あきらかずき	彰かずき	固有人名*	宝塚
あさぞのみき	麻園みき	固有人名*	宝塚
あさぞらりほ	朝空理帆	固有人名*	宝塚
あさみひかる	朝海ひかる	固有人名*	宝塚
あさみやまゆ	朝宮真由	固有人名*	宝塚
あまみやもえ	天宮萌	固有人名*	宝塚
あらんけい	安蘭けい	固有人名*	宝塚
ありさみほ	有沙美帆	固有人名*	宝塚
かほうゆりか	香宝ゆりか	固有人名*	宝塚
きたじままみ	北嶋麻実	固有人名*	宝塚
さくらぎえみ	桜木絵美	固有人名*	宝塚
しおみまほ	汐美真帆	固有人名*	宝塚
じょうかあづき	城華阿月	固有人名*	宝塚
しらとりゆりえ	白鳥ゆりえ	固有人名*	宝塚
すずかけみゆき	鈴懸三由岐	固有人名*	宝塚
すばるかずき	昴一輝	固有人名*	宝塚
せいやゆう	聖矢優	固有人名*	宝塚
たかおりお	高央りお	固有人名*	宝塚
つづしろあい	都々城あい	固有人名*	宝塚
つぶらひとみ	都布良ひとみ	固有人名*	宝塚
ななせかい	七瀬快	固有人名*	宝塚
なるせこうき	成瀬こうき	固有人名*	宝塚
ののみるて	野乃みるて	固有人名*	宝塚
はなふさまり	花總まり	固有人名*	宝塚
はらみてき	原美笛	固有人名*	宝塚
はるのすみれ	春野寿美礼	固有人名*	宝塚
ひびやめぐみ	日比谷恵	固有人名*	宝塚
ふたばみき	双葉美樹	固有人名*	宝塚
ほなみありあ	穂波亜莉亜	固有人名*	宝塚
まいねあずさ	舞音梓	固有人名*	宝塚
まきめぐみ	真樹めぐみ	固有人名*	宝塚
まさおかなお	真丘奈央	固有人名*	宝塚
まほろばゆう	まほろば遊	固有人名*	宝塚
みすぎちか	三杉千佳	固有人名*	宝塚
みずしまあおい	水島あおい	固有人名*	宝塚
みなみしずか	南しずか	固有人名*	宝塚
ゆうなおき	悠なお輝	固有人名*	宝塚
ゆうかえり	優花えり	固有人名*	宝塚
ゆきわかな	雪わかな	固有人名*	宝塚

!! 78期生

あかさかみき	赤坂実樹	固有人名*	宝塚
あさだこう	麻田こう	固有人名*	宝塚
あまのゆか	天乃悠華	固有人名*	宝塚
あやぞのゆき	彩苑ゆき	固有人名*	宝塚
あやなまい	綾奈舞	固有人名*	宝塚
あんのりょう	安野凌	固有人名*	宝塚
うたはなゆみ	歌花由美	固有人名*	宝塚
おおぞらゆうひ	大空祐飛	固有人名*	宝塚
おおたかつばさ	大鷹つばさ	固有人名*	宝塚
おとわりょう	音羽椋	固有人名*	宝塚
かいほうたまき	海宝珠起	固有人名*	宝塚
かじゆうき	華路ゆうき	固有人名*	宝塚
きみともか	公智香	固有人名*	宝塚
けいなつき	渓なつき	固有人名*	宝塚
しづきこう	紫月光	固有人名*	宝塚
しらんますみ	紫蘭ますみ	固有人名*	宝塚
せなじゅん	瀬奈じゅん	固有人名*	宝塚
そのみやれいな	苑宮令奈	固有人名*	宝塚
たかしろけい	貴城けい	固有人名*	宝塚
だんれい	檀れい	固有人名*	宝塚
ちひろれいか	千紘れいか	固有人名*	宝塚
つかさゆうき	司祐輝	固有人名*	宝塚
なつかぜりお	夏風りお	固有人名*	宝塚
ななまりか	奈々まりか	固有人名*	宝塚
はずみるい	羽純るい	固有人名*	宝塚
はなさきりか	花咲里香	固有人名*	宝塚
はなづきあや	華月あや	固有人名*	宝塚
はなぶきまい	花吹まい	固有人名*	宝塚
はるなりお	遥奈りお	固有人名*	宝塚
ひとみりか	瞳里佳	固有人名*	宝塚
ひびきまりあ	響まりあ	固有人名*	宝塚
ひろみよし	裕三佳	固有人名*	宝塚
ほだかゆう	穂高ゆう	固有人名*	宝塚
まおなつき	真於夏希	固有人名*	宝塚
まゆづきこう	眉月凰	固有人名*	宝塚
みずほのせいか	水穂野清香	固有人名*	宝塚
みやすあり	美夜寿安里	固有人名*	宝塚
ゆうきまお	夕貴真緒	固有人名*	宝塚
ゆうなあき	夕奈あき	固有人名*	宝塚
ゆめきのあ	夢輝のあ	固有人名*	宝塚

!! 79期生

あいようこ	愛耀子	固有人名*	宝塚
あいきしゅり	愛希朱里	固有人名*	宝塚
あいみりせ	愛海理世	固有人名*	宝塚
あかねみつき	茜みつ希	固有人名*	宝塚
あきそのみお	秋園美緒	固有人名*	宝塚
あさひなけい	朝比奈慶	固有人名*	宝塚
あづさまりん	亜づさ真鈴	固有人名*	宝塚
あやさきなるみ	綾咲成美	固有人名*	宝塚
あやせさき	彩勢沙樹	固有人名*	宝塚
あゆかわなつき	鮎川夏来	固有人名*	宝塚
ありかじゅん	有香潤	固有人名*	宝塚
えりちあき	絵莉千晶	固有人名*	宝塚
おおとりれい	大鳥れい	固有人名*	宝塚
かざきまや	風輝マヤ	固有人名*	宝塚
かざほゆうり	風帆優里	固有人名*	宝塚
きくほりな	菊穂りな	固有人名*	宝塚
きさきみり	貴咲美里	固有人名*	宝塚
きたはらりま	北原里麻	固有人名*	宝塚
こうすずか	幸涼香	固有人名*	宝塚
こうのまりか	香乃毬花	固有人名*	宝塚
こしのりゅう	越乃リュウ	固有人名*	宝塚
こまりなな	小毬なな	固有人名*	宝塚
さえづきあきら	冴月晃	固有人名*	宝塚
さきのぞみ	さき望実	固有人名*	宝塚
さくまゆき	佐久真ゆき	固有人名*	宝塚
たいじゅまき	大樹槙	固有人名*	宝塚
たかせゆう	貴瀬ゆう	固有人名*	宝塚
たつつかさ	達つかさ	固有人名*	宝塚
たつきよう	立樹遥	固有人名*	宝塚
まさきかずさ	柾輝かずさ	固有人名*	宝塚
みきちぐさ	美稀千種	固有人名*	宝塚
みずなつき	水夏希	固有人名*	宝塚
みずたにしの	水谷紫乃	固有人名*	宝塚
みずはらまどか	水原まどか	固有人名*	宝塚
みちきよら	路きよら	固有人名*	宝塚
みなしろひかり	南城ひかり	固有人名*	宝塚
みらいゆうき	未来優希	固有人名*	宝塚
むこあゆむ	武庫歩	固有人名*	宝塚
むつきまお	夢月真生	固有人名*	宝塚
りりせいら	莉理せいら	固有人名*	宝塚

!! 80期生

あいだめぐ	愛田芽久	固有人名*	宝塚
あきづきしょう	秋月章	固有人名*	宝塚
あさぎゆうな	あさぎ裕南	固有人名*	宝塚
あさずみけい	朝澄けい	固有人名*	宝塚
あさまもゆ	麻真もゆ	固有人名*	宝塚
あやぶきまお	彩吹真央	固有人名*	宝塚
あゆらかお	あゆら華央	固有人名*	宝塚
あんりみちる	杏里ミチル	固有人名*	宝塚
かずゆうと	一優斗	固有人名*	宝塚
かのんしおり	花暢しおり	固有人名*	宝塚
きりやひろむ	霧矢大夢	固有人名*	宝塚
くおんまや	久遠麻耶	固有人名*	宝塚
くじあかり	久路あかり	固有人名*	宝塚
すがたこう	すがた香	固有人名*	宝塚
せんほさち	千ほさち	固有人名*	宝塚
たまきかほ	珠希かほ	固有人名*	宝塚
なづきみか	奈月みか	固有人名*	宝塚
なつほあきら	夏帆輝	固有人名*	宝塚
なみきあきら	波輝晶	固有人名*	宝塚
なるみじゅん	鳴海じゅん	固有人名*	宝塚
はつねまよ	初嶺まよ	固有人名*	宝塚
はやせあゆ	早瀬鮎	固有人名*	宝塚
はるあゆか	春あゆか	固有人名*	宝塚
はるかいっき	春鹿一輝	固有人名*	宝塚
ひしょうゆう	飛翔夕	固有人名*	宝塚
ふぶきあゆ	風吹あゆ	固有人名*	宝塚
まいはなきょう	舞花京	固有人名*	宝塚
ますみうらら	真澄うらら	固有人名*	宝塚
またけすぐる	真竹すぐる	固有人名*	宝塚
まりほえりな	毬穂えりな	固有人名*	宝塚
みずさわはづき	水沢葉月	固有人名*	宝塚
みなせあお	水瀬あお	固有人名*	宝塚
みなほかりん	南帆香凜	固有人名*	宝塚
みやえりか	美椰エリカ	固有人名*	宝塚
むらさきのゆき	紫野ゆき	固有人名*	宝塚
めいかれん	芽衣かれん	固有人名*	宝塚
ももかさり	百花沙里	固有人名*	宝塚
ゆうきまゆ	結輝真由	固有人名*	宝塚
ゆめなさや	夢奈さや	固有人名*	宝塚

!! 81期生

あやどりかんな	彩鳥かんな	固有人名*	宝塚
あやめひかる	彩愛ひかる	固有人名*	宝塚
いっしきるか	一色瑠加	固有人名*	宝塚
えれまりな	絵麗まりな	固有人名*	宝塚
おうかれいや	桜花れいや	固有人名*	宝塚
かおうれみ	花央レミ	固有人名*	宝塚
かざみよしき	風美佳希	固有人名*	宝塚
かじかくみ	梶花空未	固有人名*	宝塚
かすみふうか	花純風香	固有人名*	宝塚
かぜおいぶき	風緒いぶき	固有人名*	宝塚
けいじゅまな	京樹真那	固有人名*	宝塚
そのみかげ	苑みかげ	固有人名*	宝塚
たかはねうきょう	貴羽右京	固有人名*	宝塚
ちぐさことみ	千草ことみ	固有人名*	宝塚
つばきひろか	椿火呂花	固有人名*	宝塚
にじのゆめか	虹乃夢果	固有人名*	宝塚
はつきかなで	初輝奏	固有人名*	宝塚
はなかげみさき	華景みさき	固有人名*	宝塚
はなせみずか	花瀬みずか	固有人名*	宝塚
ひさとりえ	妃里梨江	固有人名*	宝塚
ふづきみよ	ふづき美世	固有人名*	宝塚
ほさきりんな	帆咲りんな	固有人名*	宝塚
まいかぜりら	舞風りら	固有人名*	宝塚
まちかめぐる	麻愛めぐる	固有人名*	宝塚
まつゆきかなこ	松雪可奈子	固有人名*	宝塚
まどかさくら	円さくら	固有人名*	宝塚
まとぶせい	真飛聖	固有人名*	宝塚
まりなみほ	毬奈みほ	固有人名*	宝塚
みたかのぞみ	美高望	固有人名*	宝塚
みつみあきほ	光海晶帆	固有人名*	宝塚
みもりさやか	美森さやか	固有人名*	宝塚
やまとゆうが	大和悠河	固有人名*	宝塚
ゆうまりん	悠真倫	固有人名*	宝塚
ゆきじかほ	雪路歌帆	固有人名*	宝塚
ゆめだいき	夢大輝	固有人名*	宝塚
ゆめさきみのり	夢咲みのり	固有人名*	宝塚
ゆめじほのか	夢路ほのか	固有人名*	宝塚
ゆりかしほ	ゆり香紫保	固有人名*	宝塚
よしのきょうか	美乃杏花	固有人名*	宝塚
らんかれあ	蘭香レア	固有人名*	宝塚

!! 82期生

らんじゅとむ	蘭寿とむ	固有人名*	宝塚
すずみしお	涼紫央	固有人名*	宝塚
こんのまひる	紺野まひる	固有人名*	宝塚
さいじょうみえ	西條三恵	固有人名*	宝塚
あおみたく	蒼海拓	固有人名*	宝塚
ななみさら	七海さら	固有人名*	宝塚
くすのきけいか	楠恵華	固有人名*	宝塚
まりのゆい	毬乃ゆい	固有人名*	宝塚
たちばなりや	橘梨矢	固有人名*	宝塚
ひだかきら	斐貴きら	固有人名*	宝塚
りょうがはるひ	遼河はるひ	固有人名*	宝塚
そうかずほ	壮一帆	固有人名*	宝塚
すずのかつき	涼乃かつき	固有人名*	宝塚
みかぜまいら	美風舞良	固有人名*	宝塚
ひめこだま	姫こだま	固有人名*	宝塚
めむちさと	芽夢ちさと	固有人名*	宝塚
みすみかのん	水純花音	固有人名*	宝塚
さわきくるみ	沢樹くるみ	固有人名*	宝塚
ちはやまえ	千早真永	固有人名*	宝塚
まいさかゆきこ	舞坂ゆき子	固有人名*	宝塚
あやかぜらん	彩風蘭	固有人名*	宝塚
たかきあまね	良基天音	固有人名*	宝塚
けんるいす	研ルイス	固有人名*	宝塚
みねけいと	嶺恵斗	固有人名*	宝塚
はなみやあいり	華宮あいり	固有人名*	宝塚
かのうちか	叶千佳	固有人名*	宝塚
はやみりき	速水リキ	固有人名*	宝塚
みずしろれな	水城レナ	固有人名*	宝塚
つきふねさらら	月船さらら	固有人名*	宝塚
さえきせいや	冴輝星也	固有人名*	宝塚
ほしかぜえれな	星風エレナ	固有人名*	宝塚
あさかせれな	麻夏せれな	固有人名*	宝塚
つきおかななお	月丘七央	固有人名*	宝塚
あゆなさえ	鮎奈さえ	固有人名*	宝塚
みひろせいさ	未宙星沙	固有人名*	宝塚
しろかこゆ	白樺湖夕	固有人名*	宝塚
あおぞらやひろ	青空弥ひろ	固有人名*	宝塚
きのことせ	輝乃琴星	固有人名*	宝塚

!! 83期生

あませいづる	天勢いづる	固有人名*	宝塚
あやのかなみ	彩乃かなみ	固有人名*	宝塚
みおうらら	澪うらら	固有人名*	宝塚
しじょうるい	紫城るい	固有人名*	宝塚
こいずみきらら	湖泉きらら	固有人名*	宝塚
あいねはれい	愛音羽麗	固有人名*	宝塚
たくまさき	拓麻早希	固有人名*	宝塚
あさないるみ	朝菜いるみ	固有人名*	宝塚
すずはらんの	涼葉らんの	固有人名*	宝塚
あもうたまき	天羽珠紀	固有人名*	宝塚
なつめりん	夏芽凛	固有人名*	宝塚
はなきゆいな	花綺ゆいな	固有人名*	宝塚
ことまりえ	琴まりえ	固有人名*	宝塚
ひいろもえ	陽色萌	固有人名*	宝塚
ゆうみひろ	悠未ひろ	固有人名*	宝塚
ゆうほさとる	祐穂さとる	固有人名*	宝塚
まみやゆき	眞宮由妃	固有人名*	宝塚
みずのちはる	水野ちはる	固有人名*	宝塚
ほうじゅこなつ	宝珠小夏	固有人名*	宝塚
しらかわるり	白河るり	固有人名*	宝塚
ひじりれい	聖れい	固有人名*	宝塚
まきせかい	牧勢海	固有人名*	宝塚
ほうじょうるみ	宝生ルミ	固有人名*	宝塚
みづきまい	水月舞	固有人名*	宝塚
なつひろみ	夏大海	固有人名*	宝塚
れいゆうき	玲有希	固有人名*	宝塚
つきしろみさき	月城美咲	固有人名*	宝塚
ちさきまりあ	千咲毬愛	固有人名*	宝塚
すずはるき	珠洲春希	固有人名*	宝塚
あやねえいか	彩音瑛花	固有人名*	宝塚
たかみりょう	貴水りょう	固有人名*	宝塚
しまあらた	紫万新	固有人名*	宝塚
はおとりの	葉音りの	固有人名*	宝塚
ふうがみなと	風雅湊	固有人名*	宝塚
ましおしん	真汐薪	固有人名*	宝塚
みふねせいか	美舟星河	固有人名*	宝塚
あんじょうしき	安城志紀	固有人名*	宝塚
れんじょうるな	蓮城ルナ	固有人名*	宝塚
もえきあやと	萌希彩人	固有人名*	宝塚
たつみきわ	巽希和	固有人名*	宝塚

!! 84期生

せんどうかほ	仙堂花歩	固有人名*	宝塚
めばえはるか	芽映はるか	固有人名*	宝塚
あさきゆめみ	麻樹ゆめみ	固有人名*	宝塚
おとづきけい	音月桂	固有人名*	宝塚
まいしろのどか	舞城のどか	固有人名*	宝塚
たかみやちなつ	高宮千夏	固有人名*	宝塚
かざりじん	風莉じん	固有人名*	宝塚
みすずあき	未涼亜希	固有人名*	宝塚
とおのあすか	遠野あすか	固有人名*	宝塚
ほくしょうかいり	北翔海莉	固有人名*	宝塚
しいなあおい	椎名葵	固有人名*	宝塚
しおかゆりさ	汐夏ゆりさ	固有人名*	宝塚
おりかなるみ	織花なるみ	固有人名*	宝塚
せおみつき	瀬央みつき	固有人名*	宝塚
はなえみく	華絵みく	固有人名*	宝塚
おおまみらん	大真みらん	固有人名*	宝塚
かじょうありあ	花城アリア	固有人名*	宝塚
きりゅうそのか	桐生園加	固有人名*	宝塚
たかれいら	貴怜良	固有人名*	宝塚
あそうあくら	麻生あくら	固有人名*	宝塚
まきかおる	真木薫	固有人名*	宝塚
くろさわだりあ	黒澤だりあ	固有人名*	宝塚
うしおわか	潮和歌	固有人名*	宝塚
はやぶささつき	隼颯希	固有人名*	宝塚
きぶねなお	貴船尚	固有人名*	宝塚
ゆめぞのまい	夢園麻衣	固有人名*	宝塚
りょうまとも	涼麻とも	固有人名*	宝塚
あやかれい	綺華れい	固有人名*	宝塚
さわねかずき	沢音和希	固有人名*	宝塚
たいがむつみ	大河睦	固有人名*	宝塚
しらはねゆり	白羽ゆり	固有人名*	宝塚
ゆきなつぐみ	雪菜つぐみ	固有人名*	宝塚
ちことひめか	千琴ひめか	固有人名*	宝塚
あさぶきゆいか	麻吹由衣加	固有人名*	宝塚
たかとおあずさ	高遠梓	固有人名*	宝塚
ほすみさえ	甫純冴	固有人名*	宝塚
なつおこまき	夏央小槇	固有人名*	宝塚
みしろれん	美城れん	固有人名*	宝塚
さわまなほ	沙和真奈帆	固有人名*	宝塚

!! 85期生

みほうあや	美鳳あや	固有人名*	宝塚
ゆずきれおん	柚希礼音	固有人名*	宝塚
みわあさひ	美羽あさひ	固有人名*	宝塚
さくらいちか	桜一花	固有人名*	宝塚
おときすなお	音姫すなお	固有人名*	宝塚
かみづきあかね	神月茜	固有人名*	宝塚
たかみやりな	高宮里菜	固有人名*	宝塚
ななせきら	七星きら	固有人名*	宝塚
まいさきりん	舞咲りん	固有人名*	宝塚
すずしろまりな	涼城まりな	固有人名*	宝塚
えみくらら	映美くらら	固有人名*	宝塚
そうのはると	奏乃はると	固有人名*	宝塚
やましなあい	山科愛	固有人名*	宝塚
ななほひかる	七帆ひかる	固有人名*	宝塚
まのすがた	真野すがた	固有人名*	宝塚
もりさきかぐや	森咲かぐや	固有人名*	宝塚
ましろふあり	真白ふあり	固有人名*	宝塚
しきぶいろは	式部いろは	固有人名*	宝塚
はながたひかる	華形ひかる	固有人名*	宝塚
じんれいか	神麗華	固有人名*	宝塚
あまぎりまよ	天霧真世	固有人名*	宝塚
あおきいずみ	青樹泉	固有人名*	宝塚
うめぞのさち	梅園紗千	固有人名*	宝塚
おとのいづみ	音乃いづみ	固有人名*	宝塚
はづきさら	葉月さら	固有人名*	宝塚
みなみまり	南海まり	固有人名*	宝塚
おおみあこ	大海亜呼	固有人名*	宝塚
はなぎりわかな	華桐わかな	固有人名*	宝塚
はなもりまゆり	花森まゆり	固有人名*	宝塚
ときいりす	十輝いりす	固有人名*	宝塚
こさきひより	湖咲ひより	固有人名*	宝塚
てんしょうゆうり	天翔ゆうり	固有人名*	宝塚
ぎんがあみ	銀河亜未	固有人名*	宝塚
かほあんな	花帆杏奈	固有人名*	宝塚
みねきあやと	嶺輝あやと	固有人名*	宝塚
あやなおと	彩那音	固有人名*	宝塚
あまのほたる	天野ほたる	固有人名*	宝塚
じゅんあいら	純あいら	固有人名*	宝塚
ひいらぎともえ	柊巴	固有人名*	宝塚
おとせしゅか	音瀬朱夏	固有人名*	宝塚

!! 86期生

あやみはや	彩海早矢	固有人名*	宝塚
かずりょうか	和涼華	固有人名*	宝塚
みねかひさり	峰華ひさり	固有人名*	宝塚
そらきれいか	宙輝れいか	固有人名*	宝塚
こじょうゆきの	湖城ゆきの	固有人名*	宝塚
もちづきりせ	望月理世	固有人名*	宝塚
とうかゆりの	憧花ゆりの	固有人名*	宝塚
まなみそら	真波そら	固有人名*	宝塚
ひづきはな	陽月華	固有人名*	宝塚
あゆせみと	鮎瀬美都	固有人名*	宝塚
しろさきあい	城咲あい	固有人名*	宝塚
たままゆら	珠まゆら	固有人名*	宝塚
なつきれお	夏輝れお	固有人名*	宝塚
あまおけいか	天緒圭花	固有人名*	宝塚
まいなりおん	舞名里音	固有人名*	宝塚
あやはなちか	綾花ちか	固有人名*	宝塚
せいじょうかいと	星条海斗	固有人名*	宝塚
りんかせら	凜華せら	固有人名*	宝塚
かわいみずほ	花愛瑞穂	固有人名*	宝塚
おうきかなめ	凰稀かなめ	固有人名*	宝塚
せいのかじゅ	聖野花珠	固有人名*	宝塚
はなみゆうか	華美ゆうか	固有人名*	宝塚
しほうななみ	紫峰七海	固有人名*	宝塚
しきえりお	姿樹えり緒	固有人名*	宝塚
あいのりほ	愛野りほ	固有人名*	宝塚
はなのじゅりあ	花野じゅりあ	固有人名*	宝塚
かずきしん	一輝慎	固有人名*	宝塚
あさくらももこ	麻倉ももこ	固有人名*	宝塚
ほづきはるな	穂月はるな	固有人名*	宝塚
あおばみちる	青葉みちる	固有人名*	宝塚
はるみおおら	遥海おおら	固有人名*	宝塚
おづきとおま	緒月遠麻	固有人名*	宝塚
みことさなえ	美琴さなえ	固有人名*	宝塚
すずはなりさ	涼花リサ	固有人名*	宝塚
なつぞらももみ	夏空李光	固有人名*	宝塚
ひほうこころ	妃鳳こころ	固有人名*	宝塚
はつせゆか	初瀬有花	固有人名*	宝塚
くさなぎもえ	草凪萌	固有人名*	宝塚
あさぎりしの	朝桐紫乃	固有人名*	宝塚
つきじかなで	月路奏	固有人名*	宝塚
たにみずせ	谷みずせ	固有人名*	宝塚
はなおからら	華岡らら	固有人名*	宝塚
てんがゆうと	天河佑斗	固有人名*	宝塚

!! 87期生

るねまいか	瑠音舞佳	固有人名*	宝塚
さおうくらま	沙央くらま	固有人名*	宝塚
かしろきほ	華城季帆	固有人名*	宝塚
つるみまゆう	鶴美舞夕	固有人名*	宝塚
みゆめひまり	美夢ひまり	固有人名*	宝塚
おとはなゆり	音花ゆり	固有人名*	宝塚
しみずきょうか	紫水梗華	固有人名*	宝塚
かずねみおう	和音美桜	固有人名*	宝塚
やくもみか	八雲美佳	固有人名*	宝塚
はるかみどり	晴華みどり	固有人名*	宝塚
あやづきせり	綾月せり	固有人名*	宝塚
あやはしみゆ	彩橋みゆ	固有人名*	宝塚
もえかゆりあ	萌花ゆりあ	固有人名*	宝塚
しらほりん	白帆凜	固有人名*	宝塚
さきはなあん	咲花杏	固有人名*	宝塚
みなほさり	南帆サリ	固有人名*	宝塚
せいきはんな	星紀はんな	固有人名*	宝塚
はつひめさあや	初姫さあや	固有人名*	宝塚
さぎりせいな	早霧せいな	固有人名*	宝塚
ゆめのせいか	夢乃聖夏	固有人名*	宝塚
みさきれい	岬麗	固有人名*	宝塚
おとみゆうま	音海ゆうま	固有人名*	宝塚
ひなたさん	日向燦	固有人名*	宝塚
まいはめぐみ	舞羽恵	固有人名*	宝塚
はなおこのみ	花緒このみ	固有人名*	宝塚
しようれね	紫陽レネ	固有人名*	宝塚
みまきさきょう	美牧冴京	固有人名*	宝塚
かのせいや	華乃星矢	固有人名*	宝塚
まりきとわ	鞠輝とわ	固有人名*	宝塚
しらとりかすが	白鳥かすが	固有人名*	宝塚
りゅうまさき	龍真咲	固有人名*	宝塚
かりんもゆる	華凜もゆる	固有人名*	宝塚
えのきとうや	榎登也	固有人名*	宝塚
ともかしゅり	朋夏朱里	固有人名*	宝塚
まとうかなた	真灯かなた	固有人名*	宝塚
あつきれんか	麻月れんか	固有人名*	宝塚
いさきまおと	衣咲真音	固有人名*	宝塚
あやみづき	彩みづ希	固有人名*	宝塚
じゅんかまりい	純花まりい	固有人名*	宝塚
ちひろゆう	千尋悠	固有人名*	宝塚
くさかぜなな	草風なな	固有人名*	宝塚
しおうみやび	姿央みやび	固有人名*	宝塚

!! 88期生

おおなぎまお	大凪真生	固有人名*	宝塚
ななかぜうみ	七風宇海	固有人名*	宝塚
ゆめかあやり	夢華あやり	固有人名*	宝塚
はざきまな	羽咲まな	固有人名*	宝塚
はなののみ	花ののみ	固有人名*	宝塚
ゆうずみしゅん	祐澄しゅん	固有人名*	宝塚
こうづきるう	光月るう	固有人名*	宝塚
はるかぜみさと	春風弥里	固有人名*	宝塚
かようきらり	華耀きらり	固有人名*	宝塚
あさかまなと	朝夏まなと	固有人名*	宝塚
おうぎめぐむ	扇めぐむ	固有人名*	宝塚
さくらのあやね	桜乃彩音	固有人名*	宝塚
さはなまこ	早花まこ	固有人名*	宝塚
はなつゆすみか	花露すみか	固有人名*	宝塚
あさはなりんか	麻華りんか	固有人名*	宝塚
あいずみもえり	愛純もえり	固有人名*	宝塚
かげつみやこ	夏月都	固有人名*	宝塚
みずきりょう	水輝涼	固有人名*	宝塚
むらさきいつみ	紫いつみ	固有人名*	宝塚
はむろちあり	葉室ちあ理	固有人名*	宝塚
つきおかずさ	月央和沙	固有人名*	宝塚
しゆうみれい	紫友みれい	固有人名*	宝塚
はなそのみゆう	華苑みゆう	固有人名*	宝塚
はすみゆうや	蓮水ゆうや	固有人名*	宝塚
まおうあきと	真央あきと	固有人名*	宝塚
あおいふぶき	葵吹雪	固有人名*	宝塚
ゆうきせんじゅ	祐輝千寿	固有人名*	宝塚
あやねらいら	綾音らいら	固有人名*	宝塚
あやおじゅね	彩央寿音	固有人名*	宝塚
せいかまい	聖花まい	固有人名*	宝塚
まひろしゅん	麻尋しゅん	固有人名*	宝塚
はなかげありす	花影アリス	固有人名*	宝塚
だいごせしる	大湖せしる	固有人名*	宝塚
ほうしょうだい	鳳翔大	固有人名*	宝塚
まあさひとみ	真麻ひとみ	固有人名*	宝塚
ひさきせあら	妃咲せあら	固有人名*	宝塚
つづみえいか	鼓英夏	固有人名*	宝塚
せんはふり	千はふり	固有人名*	宝塚
ゆうぎりらい	夕霧らい	固有人名*	宝塚
かおあみり	華央あみり	固有人名*	宝塚
さいかりょう	彩夏涼	固有人名*	宝塚
しずかちな	雫花ちな	固有人名*	宝塚
さらんえりか	紗蘭えりか	固有人名*	宝塚
あさねさつと	麻音颯斗	固有人名*	宝塚
やしおゆうみ	八汐ゆう美	固有人名*	宝塚
となんさきら	斗南さきら	固有人名*	宝塚
くれないゆずる	紅ゆずる	固有人名*	宝塚
おりよしの	織佳乃	固有人名*	宝塚

!! 89期生

あいきゆま	愛輝ゆま	固有人名*	宝塚
あいさもも	愛紗もも	固有人名*	宝塚
あいはなちさき	愛花ちさき	固有人名*	宝塚
あおみりま	碧海りま	固有人名*	宝塚
あかつきごう	暁郷	固有人名*	宝塚
あすみりお	明日海りお	固有人名*	宝塚
あまみやなお	天宮菜生	固有人名*	宝塚
あもんまち	亜門真地	固有人名*	宝塚
いすずひかり	五十鈴ひかり	固有人名*	宝塚
いちじょうあずさ	壱城あずさ	固有人名*	宝塚
うらきひろと	浦輝ひろと	固有人名*	宝塚
おおつきさゆ	大月さゆ	固有人名*	宝塚
おうじゅひらり	桜寿ひらり	固有人名*	宝塚
かおんゆうき	香音有希	固有人名*	宝塚
かしょうなおと	香翔なおと	固有人名*	宝塚
きさきひなの	姫咲ひなの	固有人名*	宝塚
ここまりあ	湖々マリア	固有人名*	宝塚
さつきあいな	沙月愛奈	固有人名*	宝塚
さわきりず	沢希理寿	固有人名*	宝塚
じゅんやちとせ	純矢ちとせ	固有人名*	宝塚
しらはなれみ	白華れみ	固有人名*	宝塚
しらみねさゆり	白峰さゆり	固有人名*	宝塚
すずせみうと	涼瀬みうと	固有人名*	宝塚
なぎなるうみ	凪七瑠海	固有人名*	宝塚
ななみひろき	七海ひろき	固有人名*	宝塚
なるかまりん	成花まりん	固有人名*	宝塚
のぞみふうと	望海風斗	固有人名*	宝塚
はさぎつばさ	羽鷺つばさ	固有人名*	宝塚
はざくらしずく	羽桜しずく	固有人名*	宝塚
はつきよしや	初輝よしや	固有人名*	宝塚
はなかゆりん	花夏ゆりん	固有人名*	宝塚
はなさきりりか	花咲りりか	固有人名*	宝塚
はなづきゆま	華月由舞	固有人名*	宝塚
はるなひとみ	遥奈瞳	固有人名*	宝塚
ひのあんじ	妃乃あんじ	固有人名*	宝塚
ひみやさくら	妃宮さくら	固有人名*	宝塚
まいきあゆみ	舞姫あゆみ	固有人名*	宝塚
まいやりり	舞椰莉々	固有人名*	宝塚
まりむらかおる	茉莉邑薫	固有人名*	宝塚
みおのせいら	澪乃せいら	固有人名*	宝塚
みしょうかずき	美翔かずき	固有人名*	宝塚
みねのかずま	嶺乃一真	固有人名*	宝塚
みやるりか	美弥るりか	固有人名*	宝塚
みやびおうか	雅桜歌	固有人名*	宝塚
もえのりりあ	萌野りりあ	固有人名*	宝塚
ゆずのれいか	柚乃玲花	固有人名*	宝塚
ゆめさきねね	夢咲ねね	固有人名*	宝塚
りゅうきかずと	流輝一斗	固有人名*	宝塚
れんじょうまこと	蓮城まこと	固有人名*	宝塚

!! 90期生

あいはらみか	愛原実花	固有人名*	宝塚
あおのゆき	蒼乃夕妃	固有人名*	宝塚
あさかぜれい	朝風れい	固有人名*	宝塚
あさとまお	朝都まお	固有人名*	宝塚
あさなぎまな	朝凪麻名	固有人名*	宝塚
あずさはるき	梓晴輝	固有人名*	宝塚
あまかぜいぶき	天風いぶき	固有人名*	宝塚
あやしろれあ	彩城レア	固有人名*	宝塚
あやはねまや	彩羽真矢	固有人名*	宝塚
あやほしりおん	彩星りおん	固有人名*	宝塚
うづきはやて	宇月颯	固有人名*	宝塚
うめさきいぶ	梅咲衣舞	固有人名*	宝塚
おうかれの	凰華れの	固有人名*	宝塚
かいはやと	海隼人	固有人名*	宝塚
かいどうのぞむ	海桐望	固有人名*	宝塚
かざねまゆき	風音まゆき	固有人名*	宝塚
かざはねれいあ	風羽玲亜	固有人名*	宝塚
かのんまい	花音舞	固有人名*	宝塚
かほうしおり	夏鳳しおり	固有人名*	宝塚
かりょうしずる	香綾しずる	固有人名*	宝塚
きさらぎれん	如月蓮	固有人名*	宝塚
こうがあさひ	煌雅あさひ	固有人名*	宝塚
こうみまいと	光海舞人	固有人名*	宝塚
ことねかずは	琴音和葉	固有人名*	宝塚
ことはさくらこ	琴羽桜子	固有人名*	宝塚
さえづきるな	冴月瑠那	固有人名*	宝塚
さくまたかね	咲真たかね	固有人名*	宝塚
しおつきしゅう	汐月しゅう	固有人名*	宝塚
しろたえなつ	白妙なつ	固有人名*	宝塚
すずねりょう	寿々音綾	固有人名*	宝塚
せいがりょう	聖河椋	固有人名*	宝塚
せとかずや	瀬戸かずや	固有人名*	宝塚
ちかぜかれん	千風カレン	固有人名*	宝塚
ちすずまゆ	千鈴まゆ	固有人名*	宝塚
ときわみづの	常盤みづの	固有人名*	宝塚
なおきじゅん	直樹じゅん	固有人名*	宝塚
なつしろらんか	夏城らんか	固有人名*	宝塚
はなかぜみらい	花風みらい	固有人名*	宝塚
ひとみゆゆ	瞳ゆゆ	固有人名*	宝塚
ひびきれおな	響れおな	固有人名*	宝塚
ほうじゅいち	鳳樹いち	固有人名*	宝塚
みかげりん	美影凜	固有人名*	宝塚
みずはかなと	瑞羽奏都	固有人名*	宝塚
みなかぜりな	南風里名	固有人名*	宝塚
めぶきゆきな	芽吹幸奈	固有人名*	宝塚
ゆうづきれな	悠月れな	固有人名*	宝塚
ゆうなはやき	悠南はやき	固有人名*	宝塚
よしのほのか	美乃ほのか	固有人名*	宝塚
りょうかぐら	遼かぐら	固有人名*	宝塚
れみくれあ	玲実くれあ	固有人名*	宝塚

!! 91期生

あいみせれな	愛水せれ奈	固有人名*	宝塚
あうらまき	あうら真輝	固有人名*	宝塚
あやさきめい	彩咲めい	固有人名*	宝塚
あやせあきな	綾瀬あきな	固有人名*	宝塚
ありせそう	有瀬そう	固有人名*	宝塚
うたかぜすい	詩風翠	固有人名*	宝塚
うららもえ	麗百愛	固有人名*	宝塚
おうがみつき	央雅光希	固有人名*	宝塚
おおきまこと	大輝真琴	固有人名*	宝塚
おおとりまゆ	鳳真由	固有人名*	宝塚
おとはみのり	音波みのり	固有人名*	宝塚
かちょうしほ	花蝶しほ	固有人名*	宝塚
かなきょうこ	花菜響子	固有人名*	宝塚
かなみかり	華那みかり	固有人名*	宝塚
きせみらの	希世みらの	固有人名*	宝塚
きとりまりや	稀鳥まりや	固有人名*	宝塚
きらまさと	輝良まさと	固有人名*	宝塚
ことしろまなか	琴城まなか	固有人名*	宝塚
このはないのり	此花いの莉	固有人名*	宝塚
さえきちはや	冴輝ちはや	固有人名*	宝塚
さきあかね	咲希あかね	固有人名*	宝塚
ささらえる	笹良える	固有人名*	宝塚
しざきひろか	紫咲大佳	固有人名*	宝塚
しもんゆりや	紫門ゆりや	固有人名*	宝塚
しらきあかり	白姫あかり	固有人名*	宝塚
しらなぎすず	白渚すず	固有人名*	宝塚
しらゆきさちか	白雪さち花	固有人名*	宝塚
しんげつさく	真月咲	固有人名*	宝塚
すみきさやと	澄輝さやと	固有人名*	宝塚
せんじゅはる	千寿はる	固有人名*	宝塚
そうまねお	颯舞音桜	固有人名*	宝塚
たかちあお	貴千碧	固有人名*	宝塚
たかむらゆうき	篁祐希	固有人名*	宝塚
てんじゅみつき	天寿光希	固有人名*	宝塚
てんれいみおん	天玲美音	固有人名*	宝塚
とうまかずき	透真かずき	固有人名*	宝塚
ののすみか	野々すみ花	固有人名*	宝塚
はなさとまな	花里まな	固有人名*	宝塚
はなみねちはる	花峰千春	固有人名*	宝塚
はるさきころん	春咲ころん	固有人名*	宝塚
はるはなきらら	春花きらら	固有人名*	宝塚
ひなづきおとは	雛月乙葉	固有人名*	宝塚
ふじさきえり	藤咲えり	固有人名*	宝塚
まいかくるみ	舞花くるみ	固有人名*	宝塚
まさぶきみのり	真吹みのり	固有人名*	宝塚
まなかあゆ	愛加あゆ	固有人名*	宝塚
ゆうかりこ	優香りこ	固有人名*	宝塚

!! 92期生

あいなゆうり	愛那結梨	固有人名*	宝塚
あきづきさや	煌月爽矢	固有人名*	宝塚
あまきとにか	天輝トニカ	固有人名*	宝塚
あまさきちはな	天咲千華	固有人名*	宝塚
あやなぎしょう	彩凪翔	固有人名*	宝塚
あんりまう	安里舞生	固有人名*	宝塚
おおすみれい	大澄れい	固有人名*	宝塚
かずさよしき	神房佳希	固有人名*	宝塚
きざきれお	輝咲玲央	固有人名*	宝塚
きづきみれい	貴月美礼	固有人名*	宝塚
ぎんかすい	銀華水	固有人名*	宝塚
けんざきゆうか	剣崎裕歌	固有人名*	宝塚
さはねゆな	紗羽優那	固有人名*	宝塚
しづきおとね	紫月音寧	固有人名*	宝塚
しょうのちお	笙乃茅桜	固有人名*	宝塚
しらゆりひめ	白百合ひめ	固有人名*	宝塚
すみれのれい	すみれ乃麗	固有人名*	宝塚
せきゆりと	瀬稀ゆりと	固有人名*	宝塚
たかすみはやと	貴澄隼人	固有人名*	宝塚
ちなみからん	千海華蘭	固有人名*	宝塚
ちされいな	千紗れいな	固有人名*	宝塚
つきえじゅま	月映樹茉	固有人名*	宝塚
つきのひめか	月野姫花	固有人名*	宝塚
てんまみちる	天真みちる	固有人名*	宝塚
とうみさらさ	透水さらさ	固有人名*	宝塚
はつはなみさき	初花美咲	固有人名*	宝塚
はなおりちさ	花織千桜	固有人名*	宝塚
はなしろまい	花城舞	固有人名*	宝塚
はなきまほ	花輝真帆	固有人名*	宝塚
ひしろゆあ	妃白ゆあ	固有人名*	宝塚
ひだかだいち	日高大地	固有人名*	宝塚
ふうりみずか	風凛水花	固有人名*	宝塚
ほうづきあん	鳳月杏	固有人名*	宝塚
ほんじょうくれは	本城くれは	固有人名*	宝塚
まあいすずか	真愛涼歌	固有人名*	宝塚
まいのゆか	舞乃ゆか	固有人名*	宝塚
まかぜすずほ	真風涼帆	固有人名*	宝塚
まつかぜあきら	松風輝	固有人名*	宝塚
まなはると	真那春人	固有人名*	宝塚
まなせはるか	真瀬はるか	固有人名*	宝塚
まりかゆめ	鞠花ゆめ	固有人名*	宝塚
みはるあやか	美春あやか	固有人名*	宝塚
ももはなひな	桃花ひな	固有人名*	宝塚
ももちいと	百千糸	固有人名*	宝塚
ゆめりみこ	夢莉みこ	固有人名*	宝塚
らんのはな	蘭乃はな	固有人名*	宝塚
りんじょうきら	凛城きら	固有人名*	宝塚
わかなつあやめ	若夏あやめ	固有人名*	宝塚

!! 93期生

あいしろもあ	愛白もあ	固有人名*	宝塚
あいづきひかる	愛月ひかる	固有人名*	宝塚
あせいいつき	亜聖樹	固有人名*	宝塚
あやかぜさきな	彩風咲奈	固有人名*	宝塚
おうさきあやか	桜咲彩花	固有人名*	宝塚
おうしなゆう	凰姿有羽	固有人名*	宝塚
かざみけいと	風海恵斗	固有人名*	宝塚
きじょうみつる	輝城みつる	固有人名*	宝塚
さなゆずは	紗那ゆずは	固有人名*	宝塚
さほゆかり	桜帆ゆかり	固有人名*	宝塚
さやかしおん	彩歌しおん	固有人名*	宝塚
しょうがつばき	翔我つばき	固有人名*	宝塚
すずらんまあや	鈴蘭まあや	固有人名*	宝塚
せおとりさ	瀬音リサ	固有人名*	宝塚
せりかとあ	芹香斗亜	固有人名*	宝塚
そらのみゆ	空乃みゆ	固有人名*	宝塚
そらはねりく	蒼羽りく	固有人名*	宝塚
たいがりん	大河凜	固有人名*	宝塚
たまはなゆふ	珠華ゆふ	固有人名*	宝塚
ちせひじり	千瀬聖	固有人名*	宝塚
つづきみあ	都月みあ	固有人名*	宝塚
とあれいや	十碧れいや	固有人名*	宝塚
なぎさせいな	凪咲星南	固有人名*	宝塚
なつきれい	夏樹れい	固有人名*	宝塚
ななくらら	菜那くらら	固有人名*	宝塚
ななせりりこ	七瀬りりこ	固有人名*	宝塚
はななみお	花奈澪	固有人名*	宝塚
はなひみら	花陽みら	固有人名*	宝塚
はなぶきのあ	華吹乃愛	固有人名*	宝塚
ほうりゅうあや	鳳龍あや	固有人名*	宝塚
ほかぜなるみ	帆風成海	固有人名*	宝塚
ほしきつばさ	星輝つばさ	固有人名*	宝塚
ほしなゆたか	星那由貴	固有人名*	宝塚
ほしぶきあやと	星吹彩翔	固有人名*	宝塚
まいそのるり	舞園るり	固有人名*	宝塚
まいはねみみ	舞羽美海	固有人名*	宝塚
まおんきあら	舞遠きあら	固有人名*	宝塚
まきいづみ	真輝いづみ	固有人名*	宝塚
まりんかんな	真凛カンナ	固有人名*	宝塚
みずせちあき	水瀬千秋	固有人名*	宝塚
みそらかれん	美宙果恋	固有人名*	宝塚
みはなりの	美花梨乃	固有人名*	宝塚
ゆいのかなり	結乃かなり	固有人名*	宝塚
ゆきのここみ	雪乃心美	固有人名*	宝塚
ゆめきあんる	夢妃杏瑠	固有人名*	宝塚
ゆめしろえれん	夢城えれん	固有人名*	宝塚
ゆめすずりあん	夢涼りあん	固有人名*	宝塚
りんかもえ	凜華もえ	固有人名*	宝塚
るどうまさ	琉動真瑳	固有人名*	宝塚
わたるひびき	航琉ひびき	固有人名*	宝塚

!! 94期生

あいかぜゆめ	愛風ゆめ	固有人名*	宝塚
あいさきまりあ	愛咲まりあ	固有人名*	宝塚
あさひみらい	朝陽みらい	固有人名*	宝塚
あまとりいら	天翔りいら	固有人名*	宝塚
あまねさら	天舞音さら	固有人名*	宝塚
あんのこのみ	杏野このみ	固有人名*	宝塚
かがりりか	華雅りりか	固有人名*	宝塚
かがみせいや	輝海せいや	固有人名*	宝塚
かずみしょう	和海しょう	固有人名*	宝塚
きらはれお	煌羽レオ	固有人名*	宝塚
きらみるいせ	煌海ルイセ	固有人名*	宝塚
くじょうあす	久城あす	固有人名*	宝塚
こうさきらん	香咲蘭	固有人名*	宝塚
さえばなりおな	冴華りおな	固有人名*	宝塚
さおとめわかば	早乙女わかば	固有人名*	宝塚
さきはなりほ	咲花莉帆	固有人名*	宝塚
さくらねれい	桜音れい	固有人名*	宝塚
さざなみれいら	漣レイラ	固有人名*	宝塚
さちかせいら	紗愛せいら	固有人名*	宝塚
しのかりあ	紫乃加りあ	固有人名*	宝塚
しょうまじゅね	翔馬樹音	固有人名*	宝塚
すばるはなか	寿春花果	固有人名*	宝塚
せんなあやせ	仙名彩世	固有人名*	宝塚
たいきりょう	大樹りょう	固有人名*	宝塚
たかほしゅう	貴穂しゅう	固有人名*	宝塚
たまきりょう	珠城りょう	固有人名*	宝塚
にいなかほ	新菜かほ	固有人名*	宝塚
はなさきあいり	花咲あいり	固有人名*	宝塚
はやみせい	隼海惺	固有人名*	宝塚
はりゅうみつき	羽立光来	固有人名*	宝塚
はるせおうき	春瀬央季	固有人名*	宝塚
ひなたのかりん	ひなたの花梨	固有人名*	宝塚
ひゅうがらん	飛河蘭	固有人名*	宝塚
ふうまかける	風馬翔	固有人名*	宝塚
ほしづきりお	星月梨旺	固有人名*	宝塚
まいづきなぎさ	舞月なぎさ	固有人名*	宝塚
まおゆうき	麻央侑希	固有人名*	宝塚
まりなまゆ	毬愛まゆ	固有人名*	宝塚
みずみれい	美泉儷	固有人名*	宝塚
みつきはるか	美月悠	固有人名*	宝塚
めいからら	芽華らら	固有人名*	宝塚
ゆうといりや	悠斗イリヤ	固有人名*	宝塚
ゆめはみゆ	夢羽美友	固有人名*	宝塚
ゆめはならん	夢花らん	固有人名*	宝塚

!! 95期生

あいすみれ	愛すみれ	固有人名*	宝塚
あいはふぶき	愛羽ふぶき	固有人名*	宝塚
あさおれん	朝央れん	固有人名*	宝塚
あさみじゅん	朝美絢	固有人名*	宝塚
あまつきつばさ	天月翼	固有人名*	宝塚
あやかまり	彩花まり	固有人名*	宝塚
おうじかおる	桜路薫	固有人名*	宝塚
おうつりさ	凰津りさ	固有人名*	宝塚
おうづきあかり	逢月あかり	固有人名*	宝塚
かえでゆき	楓ゆき	固有人名*	宝塚
かずしろるな	和城るな	固有人名*	宝塚
きづきゆうま	輝月ゆうま	固有人名*	宝塚
ことかちの	こと華千乃	固有人名*	宝塚
さくらぎみなと	桜木みなと	固有人名*	宝塚
さももさつき	早桃さつき	固有人名*	宝塚
しらみねゆり	白峰ゆり	固有人名*	宝塚
すずかまや	涼華まや	固有人名*	宝塚
せおゆりあ	瀬央ゆりあ	固有人名*	宝塚
つきしろかなと	月城かなと	固有人名*	宝塚
ななおまき	七生眞希	固有人名*	宝塚
はなえちほ	花瑛ちほ	固有人名*	宝塚
はるねあき	晴音アキ	固有人名*	宝塚
ひざくらほのり	妃桜ほのり	固有人名*	宝塚
ひなみふう	妃海風	固有人名*	宝塚
ひろかゆう	ひろ香祐	固有人名*	宝塚
ほしのあんり	星乃あんり	固有人名*	宝塚
まいひなの	真衣ひなの	固有人名*	宝塚
まなきれいか	愛希れいか	固有人名*	宝塚
まほうつぐみ	真鳳つぐみ	固有人名*	宝塚
まみやすずこ	真みや涼子	固有人名*	宝塚
みさきりおん	実咲凜音	固有人名*	宝塚
みさとゆめの	美里夢乃	固有人名*	宝塚
みなみまいと	水美舞斗	固有人名*	宝塚
みらんれんな	美蘭レンナ	固有人名*	宝塚
みれいじゅん	実羚淳	固有人名*	宝塚
むらさきりら	紫りら	固有人名*	宝塚
もえぶきまほろ	萌吹まほろ	固有人名*	宝塚
ゆうひかる	優ひかる	固有人名*	宝塚
ゆきはなさくら	雪華さくら	固有人名*	宝塚
ゆずかれい	柚香光	固有人名*	宝塚
るみじゅん	留美絢	固有人名*	宝塚
れいまこと	礼真琴	固有人名*	宝塚
れいなゆう	麗奈ゆう	固有人名*	宝塚
れいみうらら	伶美うらら	固有人名*	宝塚
れんじゅこうき	蓮珠こうき	固有人名*	宝塚

!! 96期生

あおいみき	蒼井美樹	固有人名*	宝塚
あかねこなつ	茜小夏	固有人名*	宝塚
あきねひかる	秋音光	固有人名*	宝塚
あさづききわ	朝月希和	固有人名*	宝塚
あさみずりょう	朝水りょう	固有人名*	宝塚
おういぶき	凰いぶき	固有人名*	宝塚
おうましおん	桜舞しおん	固有人名*	宝塚
おとさきいつき	音咲いつき	固有人名*	宝塚
おとはねえみ	乙羽映見	固有人名*	宝塚
かずきそら	和希そら	固有人名*	宝塚
かのまりあ	花乃まりあ	固有人名*	宝塚
かのはとき	叶羽時	固有人名*	宝塚
かれんえみり	華蓮エミリ	固有人名*	宝塚
きさきあいり	綺咲愛里	固有人名*	宝塚
ごじょうまりな	五條まりな	固有人名*	宝塚
さきひみゆ	咲妃みゆ	固有人名*	宝塚
さくらなあい	桜奈あい	固有人名*	宝塚
さらさなち	更紗那知	固有人名*	宝塚
しどうりゅう	紫藤りゅう	固有人名*	宝塚
しらとりゆりや	白鳥ゆりや	固有人名*	宝塚
せとはなまり	瀬戸花まり	固有人名*	宝塚
そうやともき	蒼矢朋季	固有人名*	宝塚
そらなみこう	空波輝	固有人名*	宝塚
たかしなりょう	貴姿りょう	固有人名*	宝塚
たくとれい	拓斗れい	固有人名*	宝塚
たちばなこう	橘幸	固有人名*	宝塚
ちゆきあき	千幸あき	固有人名*	宝塚
はやきゆうと	颯希有翔	固有人名*	宝塚
はるみゆう	春海ゆう	固有人名*	宝塚
ひめはなゆきの	妃華ゆきの	固有人名*	宝塚
まちゆうか	真地佑果	固有人名*	宝塚
みおうえりな	美桜エリナ	固有人名*	宝塚
むつきせら	夢月せら	固有人名*	宝塚
ゆうなみけい	優波慧	固有人名*	宝塚
ゆめかあみ	夢華あみ	固有人名*	宝塚
ゆめなるね	夢奈瑠音	固有人名*	宝塚
らんまゆう	蘭舞ゆう	固有人名*	宝塚
りさきしぐれ	里咲しぐれ	固有人名*	宝塚

!! 97期生

あおせゆうき	蒼瀬侑季	固有人名*	宝塚
あおみやるか	碧宮るか	固有人名*	宝塚
あきなるい	秋奈るい	固有人名*	宝塚
あさぎりまこと	朝霧真	固有人名*	宝塚
あさひなあおい	朝日奈蒼	固有人名*	宝塚
あやきひかり	綺城ひか理	固有人名*	宝塚
いろはれお	彩葉玲央	固有人名*	宝塚
うみのみつき	海乃美月	固有人名*	宝塚
おうはみらい	凰羽みらい	固有人名*	宝塚
かしろあおい	佳城葵	固有人名*	宝塚
かとりれいら	華鳥礼良	固有人名*	宝塚
かのうゆうり	叶ゆうり	固有人名*	宝塚
くれはまき	紅羽真希	固有人名*	宝塚
さいづきつくし	彩月つくし	固有人名*	宝塚
さらあんな	沙羅アンナ	固有人名*	宝塚
さわかづき	澤佳津伎	固有人名*	宝塚
しろきみれい	城妃美伶	固有人名*	宝塚
たかとおすず	貴遠すず	固有人名*	宝塚
とうどうじゅん	桃堂純	固有人名*	宝塚
とわきせあ	永久輝せあ	固有人名*	宝塚
はなびしりず	花菱りず	固有人名*	宝塚
はるひうらら	春妃うらら	固有人名*	宝塚
ひなりりか	雛リリカ	固有人名*	宝塚
ひめさきみれい	姫咲美礼	固有人名*	宝塚
ひめのれえ	ひめ乃礼絵	固有人名*	宝塚
まいやせいか	舞矢聖華	固有人名*	宝塚
みずかいち	水香依千	固有人名*	宝塚
みずさるる	水沙瑠流	固有人名*	宝塚
みなづきまき	水月牧	固有人名*	宝塚
やぶきせな	矢吹世奈	固有人名*	宝塚
ゆめなつき	夢なつき	固有人名*	宝塚
ゆめとあさみ	夢人麻未	固有人名*	宝塚
るいまきせ	留依蒔世	固有人名*	宝塚
れんつかさ	蓮つかさ	固有人名*	宝塚

!! 98期生

あかつきちせい	暁千星	固有人名*	宝塚
こはるのさよ	小春乃さよ	固有人名*	宝塚
あまはなえま	天華えま	固有人名*	宝塚
しんじょうまから	真條まから	固有人名*	宝塚
るかぜひかる	瑠風輝	固有人名*	宝塚
あやおうか	綾凰華	固有人名*	宝塚
みおのさき	澪乃桜季	固有人名*	宝塚
はるはらら	遥羽らら	固有人名*	宝塚
じゅんなすばる	潤奈すばる	固有人名*	宝塚
ひりゅうつかさ	飛龍つかさ	固有人名*	宝塚
まあやきほ	真彩希帆	固有人名*	宝塚
せいなのぞみ	星南のぞみ	固有人名*	宝塚
みとくらら	美都くらら	固有人名*	宝塚
ゆかりのこゆき	紫乃小雪	固有人名*	宝塚
あやなみけいと	彩波けいと	固有人名*	宝塚
ほまれせり	穂稀せり	固有人名*	宝塚
みなとるひ	湊瑠飛	固有人名*	宝塚
みねかとわ	峰果とわ	固有人名*	宝塚
ありさひとみ	有沙瞳	固有人名*	宝塚
うららせんり	麗泉里	固有人名*	宝塚
ゆめのかまい	夢乃花舞	固有人名*	宝塚
ななきかおる	七輝かおる	固有人名*	宝塚
ほうかはるな	鳳華はるな	固有人名*	宝塚
かざきしゅん	風輝駿	固有人名*	宝塚
あまきほまれ	天希ほまれ	固有人名*	宝塚
そうませれん	蒼真せれん	固有人名*	宝塚
はなゆきりら	華雪りら	固有人名*	宝塚
かなみせな	叶海世奈	固有人名*	宝塚
きよからん	清華蘭	固有人名*	宝塚
すおうまひろ	周旺真広	固有人名*	宝塚
しざきれの	紫咲樹れの	固有人名*	宝塚
ゆうなぎりょう	夕渚りょう	固有人名*	宝塚
せなみはや	瀬南海はや	固有人名*	宝塚
おとかぜせいや	音風せいや	固有人名*	宝塚
おうかりな	桜花りな	固有人名*	宝塚
みおかあんり	美丘安里	固有人名*	宝塚
まれいさやな	茉玲さや那	固有人名*	宝塚
ひづきゆめ	妃月ゆめ	固有人名*	宝塚
なおみりせ	尚央海りせ	固有人名*	宝塚
すみづきなおと	澄月菜音	固有人名*	宝塚
